太原铁路局大秦线	locale
湖东机务段	depart2
涿鹿站	locale
大秦线	locale
太原南站	locale
太原局	depart2
北京西	locale
太原南	locale
北京西站	locale
石太上行线	locale
北同蒲下行线K101+800	locale
石太客专k235+617间	locale
石家庄下行线	locale
阳泉北站	locale
阳泉北	locale
太焦线	locale
聂村站	locale
朔州工务段	depart2
史店站	locale
礼元站	locale
南同蒲线	locale
南同蒲线史店站至礼元站间下行线K684+500	locale
侯马北站	locale
南同线	locale
京原线	locale
枣林站	locale
京原线枣林站	locale
轨道区段红光带	name
原平	locale
太原北一场	depart
韩原线	locale
应县	locale
怀仁	locale
怀仁东站	locale
太中银线	locale
褚家沟	locale
汾阳	locale
褚家沟至汾阳间上行线K1059+800	locale
吴堡站	locale
柳林南站	locale
茶坞	locale
茶坞站	locale
灵丘	locale
张礼	locale
张礼-临汾间617km+500m	locale
介休	locale
滦南	locale
乐亭	locale
滦南站	locale
店坡	locale
运城	locale
五台山	locale
集义庄	locale
渡板变形易发	reason
同蒲线	locale
同蒲线介休-太北四场间	locale
金山铺站	locale
金山铺站至五台山站间310km+227m	locale
集义庄至五台山间313km+385m	locale
魏家坡站	locale
沁县站	locale
魏家坡站至沁县站间K169+025	locale
北同蒲线	locale
吕梁站	locale
太兴线	locale
太原工务机械段	depart2
镇城底站	locale
娄烦站	locale
侯阎线	locale
稷山站	locale
百底站	locale
西街村	locale
稷山县	locale
稷山县西街村	locale
平陇村	locale
稷山县平陇村	locale
太兴下行线	locale
西张站	locale
太原局北同蒲线	locale
道岔无表示故障	name
大西高铁线	locale
闻喜	locale
侯月线	locale
太原局侯月线	locale
曲沃站	locale
太原局侯月线曲沃站	locale
宁岢线	locale
李家坪站	locale
太原局宁岢线李家坪站	locale
大同电务段	depart2
电源屏报警	name
太原供电段	depart2
柳村	locale
朔州	locale
清徐站	locale
潍坊东	locale
平顶山东	locale
侯马站	locale
史店	locale
河津站	locale
清涧	locale
秦西工务段	depart2
机车渡板变形	name
路外相撞铁路交通事故	name
防撞停车	name
电源屏报警故障	name
车辆抱闸	name
车辆冒火星	name
红光带故障	name
机间线路红光带故障	name
速断跳闸	name
断路器跳闸	name
线路过流跳闸	name
贯通电源停电	reason
区段闪红光带	name
贯通瞬间跳闸	name
铁路交通事故	name
柜速断跳闸	name
闪红光带	name
机车制动机故障	name
机车故障	name
农电故障停电	reason
信号机故障	name
移频报警	name
分路残压超限	reason
轨面有啥子	reason
分路不良	reason
4位防脱拉环变形	reason
防脱阀杆拉断	reason
装载机与车体发生过碰触	reason
制动阀杆折断	reason
装载机刮碰车体	reason
网压出现偏差	reason
插件故障	reason
车辆冒烟	name
登记时没有注明非常停车	reason
电源停电	name
接触网承力索断线	name
弓网故障	name
联锁显示器无显示故障	name
隔离开关故障	name
信号设备故障	name
异物停车	name
太原局	depart
玉门沟站	locale
全站停电及联锁显示器无显示故障	name
西山支线	locale
玉门沟配电室	depart
汾河	locale
玉门沟	locale
太西电力综合工区	depart
太原电务段	depart
玉门沟信号工区	depart
太原电务段	depart2
太原局安监室	depart
太原西站	locale
三给村站	locale
汾河配电室	depart
动车组列车主断跳闸	name
太原局大西高铁	locale
灵石东站	locale
霍州东站下行线	locale
侯马北供电段	depart
太原机务段	depart
运城北	locale
霍州东站	locale
运城北站	locale
北京局	depart
北京动车段	depart
石家庄动车所	depart
石家庄	locale
动车所D2道1列位	locale
临汾西供电车间	depart
灵石东	locale
霍州东	locale
介休东网电工区	depart
平遥古城站	locale
太原方向下行馈线	locale
太原铁路局安监室	depart
瓦日线石楼县站	locale
安监室	depart
瓦日线	locale
侯马北机务段	depart
石楼县站内5道下行线	locale
K205+777	locale
石楼县站5道95#支柱14号线	locale
石楼县站	locale
石楼县站3道	locale
石楼供电车间	depart
供电技术科	depart
太原供电段	depart
石楼网电工区	depart
石楼县	locale
隰县	locale
吕梁	locale
兴县北	locale
太原局安全监察室	depart
大西线	locale
长风街线路所	depart
太原站间大西上行线K272	locale
石太下行线	locale
214km364m	locale
大西上行线	locale
271km911m	locale
220km858m	locale
274km836m	locale
陕西高嘉电力科技有限公司	depart
北京太格时代自动化系统设备有限公司	depart
中铁六局电务公司	depart
太原南接触网工区	depart
太原南石太场	depart
长风街线路所间	depart
太原南供电车间	depart
石太	locale
大西线上下行线	locale
太原检修车间	depart
太原站间大西上行线	locale
272km572m	locale
太原南大西场	depart
太谷西站	locale
祁县东站	locale
接触网跳闸	name
南郭分区所	depart
祁县东变电所上行	locale
祁县东变电所212馈线	locale
太谷西	locale
晋中供电车间	depart
祁县东	locale
北六堡站	locale
交城站	locale
文水站	locale
汾阳站	locale
太原南东站	locale
文水网电工区	depart
北六堡网电工区	depart
吴城	locale
清徐配电室	depart
清徐	locale
褚家沟贯通线	locale
北六堡	locale
太原	locale
文水	locale
交城	locale
柳林南	locale
榆次	locale
太北库	locale
西蜀巴客联线	locale
太原机务段	depart2
太北检修车间	depart
侯月线翼城东站	locale
控制台花盘故障	name
翼城东站	locale
桥上站	locale
侯马电务段	depart
翼城东信号工区	depart
翼城东	locale
翼城站	locale
贯通电源停电	name
南常站间上下行线	locale
翼城	locale
桥上	locale
翼城配电室	depart
南常站	locale
南常	locale
翼城上行线	locale
太原局太兴线	locale
静游站	locale
娄烦站上行线	locale
娄烦站间上行线	locale
太兴线上行83km780m	locale
娄烦变电所	depart
K78+820	locale
岱岳站	locale
北周庄站	locale
路外铁路交通事故	name
大同铁路公安处	locale
朔州车务段	depart
湖东机务段	depart
山阴县	locale
辛留村	locale
湖东	locale
二铺村	locale
李家窑村	locale
晋中站	locale
太原南站大西场	depart
临汾站	locale
洪洞站	locale
临汾	locale
洪洞西间上行线	locale
500k+500m	locale
茶坞工务段	depart
大石庄监测点	locale
平谷	locale
大石庄	locale
大石庄车站	locale
蓟县西间上下行	locale
K382+500	locale
K392+000	locale
段甲岭间	locale
K0+000	locale
K6+652	locale
蓟县	locale
玻璃破碎	name
宁武	locale
大同	locale
金沙滩	locale
宋家庄	locale
宋家庄站	locale
太原铁路局车辆处	depart
车辆处	depart
车辆主管漏风	name
秦皇岛东站	locale
湖东电力机务段	depart
秦皇岛	locale
秦东站	locale
车辆漏风	name
秦皇岛运用车间	depart
秦东一场	depart
列车抱闸	name
太原北四场	depart
太原北六场	depart
0km500m	locale
太局太段	depart
太原车辆段	depart
太北运用车间	depart
车辆中部冒火花	name
高村站	locale
车辆冒火花	name
平社站	locale
287km516m	locale
万安	locale
东大沽	locale
太原北车辆段	depart
原平站	locale
高村	locale
太原站	locale
折作业漏泄	locale
温州	locale
撞鸟停车	name
太原铁路局	depart
沈阳北	locale
北戴河	locale
津秦场	depart
滦河站间上行线	locale
K252+877m	locale
太原动车所	depart
北京铁路局	depart
电务处	depart
电源屏报警故障追踪	name
石太线	locale
太原南楼	locale
北京鼎汉电源屏厂家	depart
电源屏与UPS间监测数据通道瞬间中断	reason
太南车间	depart
太北六场9G轨道区段	depart
太北六场信号工区	depart
机车列尾查不到风压	name
后营站	locale
西安铁路科学技术研究发展有限责任公司	depart
湖东无线库检工区	depart
太原通信段	depart
秦皇岛车间	depart
西张庄通信工区	depart
柳村库检工区	depart
机车B端车载列尾电台故障	reason
太原通信段	depart2
移频报警信息	name
北京铁路信号工厂	depart
翼城东信号机械室	depart
侯马检修车间	depart
翼城车间	depart
接收器特性不良	reason
侯马电务段	depart2
怀仁东检修队	depart
怀仁东站区间	depart
照明回路电缆故障	reason
山阴	locale
怀仁东	locale
大同西供电段	depart2
解县站	locale
永济	locale
永济配电室	depart
解县供电公司	depart2
娄烦供电公司	depart2
太中银台	depart
文水供电车间	depart
太南东站	locale
贯通线瞬间过流	reason
太中银电力	depart
供电处	locale
大营站	locale
五台电力工区	depart
五台山站	locale
五台	locale
信号电源供电质量不达标	reason
金山铺	locale
平型关东	locale
唐之洼	locale
古交站	locale
娄烦配电室	depart
娄古贯通	locale
娄烦供电车间	depart
大夫庄	locale
娄烦网电工区	depart
古交电力工区	depart
古交	locale
110KV降压站瞬间失压	reason
供电处	depart
代县站	locale
枣林电力	depart
枣林	locale
崞阳	locale
用电负荷未均匀分配	reason
王董堡站	locale
阳明堡站	locale
南塔底站	locale
太北	locale
青龙线	locale
太北电力综合工区	depart
皇后园站	locale
南塔底站二路电源（青龙线农电）停电	reason
韩阳镇站	locale
风陵渡	locale
韩阳镇	locale
韩阳镇地方819线路故障停电	reason
永济市供电公司	depart2
榆社站	locale
榆社电力工区	depart
榆社县供电公司	depart
榆社电力综合工区	depart
榆社城市二回线故障停电	reason
榆社供电分公司	depart2
吕梁北站	locale
西蜀巴站	locale
吴堡	locale
吕梁供电车间	depart
吕梁网电工区	depart
西蜀巴	locale
吕梁变电亭	depart
梅家庄站	locale
电力综合工区	depart
原平电力工区	depart
原平110kV变电站10kV系统市二线886回路速断跳闸	reason
轩岗	locale
忻州	locale
原平市	locale
原平地方供电公司	depart2
武乡	locale
沁县	locale
沁县电力工区	depart
继电器长期运行震动接点粘连	reason
坡头站	locale
测石站	locale
寿阳	locale
阳泉	locale
简子沟	locale
寿阳电力	depart
寿阳电力综合工区	depart
寿阳站	locale
寿阳配电室备电源失压跳闸	reason
寿阳供电公司	depart2
首阳站	locale
永济市供电公司	depart
王庄	locale
35kV变电站	depart
首阳	locale
风陵渡电力工区	depart
永济站	locale
供电公司进行拉路试验，排查故障	reason
接触网上异物处理	name
义安	locale
479km812m	locale
介休站	locale
义安站间上行线	locale
由于风力作用将塑料薄膜刮到了接触网上	reason
社科站	locale
东野线	locale
岚县	locale
娄烦	locale
社科站二路电源（东野线农电）停电	reason
岚县供电公司	depart2
褚家沟站	locale
吕梁供电公司	depart
吴城配电所	depart
王营庄	locale
太中银线褚家沟站	locale
王营庄35KV变电站因设备故障短时停电倒闸	reason
吕梁地方供电公司	depart2
中鼎物流园站	locale
贯速断跳闸	name
戎江	locale
张隆洲	locale
禇家沟区间	depart
太原南区间	depart
贯通线瞬间故障速断跳闸	reason
忻州供电车间	depart
忻州电力综合工区	depart
平社站二路农电（10kV庄磨514线平社支线）地方供电公司故障停电	reason
忻州供电公司	depart2
秦东	locale
上联线路所	depart
电源报警	name
柳村配电所	depart
抚宁配电所	depart
后营	locale
抚宁北	locale
电缆状态不良短路故障跳闸	reason
西韩岭线路所	depart
韩家岭站	locale
下行线18Km630m	locale
大西四场	depart
大同运用	depart
湖东车辆段	depart
大新下行	locale
无抱闸	reason
喊停	name
迁安北站	locale
迁安	locale
北站	locale
迁西站	locale
上行线522km111m	locale
迁西站3道	locale
迁曹	locale
大秦	locale
迁曹线	locale
罗家屯站	locale
乐亭站	locale
菱角山站	locale
平安城	locale
误拦停	reason
异音	name
异音拦停	name
太局候段	depart
两渡站	locale
侯马	locale
达曲沃站	locale
辛置站	locale
大秦车务段	depart
聂庄站	locale
葡萄线路所	depart
东港站	locale
烧荒	name
沙城东站	locale
北辛堡站	locale
沙城东线	locale
五营梁线	locale
涿鹿	locale
化稍营	locale
化稍营站	locale
护网内有行人	name
罗家屯线	locale
电务处	locale
定侯马电务段	depart
延庆站	locale
下庄站	locale
衰耗器性能不良	reason
大同电务段	depart
东河南站	locale
TDCS-A机系统故障	name
死机	reason
ATP启机故障	name
HIRM板故障	reason
北京南	locale
北京和利时系统工程有限公司	depart2
电缆芯线内部不良	reason
道岔反位无表示	name
信号掉码故障	name
八里庄站	locale
176线路	locale
至岩会站	locale
感应器电缆被挂断	reason
途中故障	name
定州东站	locale
正定机场站	locale
ALM板故障	reason
UPS监测板特性不良	reason
风压故障	name
列尾控制盒故障	reason
临汾西站	locale
逐鹿站间下行线	locale
158Km679m	locale
通信异常	reason
北京锦鸿希电信息技术股份有限公司	depart2
途中异常	name
徐水东站间下行线	locale
北张庄	locale
造成应答器	reason
南同蒲线赵城站	locale
反位失表故障	name
赵城站	locale
反位侧缺口变大	reason
侯月线曲沃站	locale
受电端室内设备存在隐患	reason
薛孤站	locale
岔定位无表示	name
缺口小	reason
CIR设备故障	name
玉田北站	locale
CIR主机语音模块故障	reason
无线调度通信设备故障	name
清涧站	locale
环境温度过高	reason
非正常停车	name
白洋淀	locale
反位侧锁钩紧	reason
定位溢流电流低	reason
辛堡站	locale
熔丝报警	name
熔断器电气特性不良	reason
太原北	locale
太原北五场	depart
岔反位溢流压力低	reason
监控装置显示器故障	name
显示器高压板逆变器电容C2虚断	reason
岚县站	locale
南同蒲线首阳站	locale
备用联锁设备报警	name
备用联锁工控机死机	reason
武乡站	locale
熔丝断丝报警	name
雷击	reason
榆次二场	depart
配线接触不良	reason
南同蒲线冷泉站	locale
冷泉站	locale
道岔定位失表故障	name
繁峙站	locale
语音记录仪故障	name
电源适配器故障	reason
安泽	locale
安泽站	locale
区间灯丝报警	name
中继站	locale
黄灯点灯单元特性不良	reason
隧道内积水严重	reason
北同蒲线里八庄站	locale
里八庄	locale
里八庄站	locale
800M电台失效故障	name
电台失效	name
主机主用通道接收故障	reason
禹门口	locale
禹门口站	locale
道岔故障报警	name
道岔故障	name
保护器总机系统死机	reason
系统死机	reason
赵城	locale
赵城站至辛置站间上行线	locale
信号机灯丝断丝报警	name
断丝报警	name
信号机黄灯主灯泡灯丝断丝	reason
灯丝断丝	reason
主机定位侧缺口变大	locale
缺口变大	locale
卡口	locale
主灯丝报警故障	name
报警线配线错误	reason
曲沃	locale
信号机突变红灯故障	name
电缆插接不良	reason
大西高铁运城北站	locale
应答器数据异常	name
应答器电缆检测盒性能不良	reason
社城站	locale
IIBG轨道电路红光带故障	name
电路红光带故障	name
下雨雷击	reason
信号机红灯断丝	reason
信号故障	name
蓟县西站	locale
蓟县西站至大石庄站间上行线	locale
上行线392Km+687m	locale
信号机左侧绿灯LED不良	reason
太北五场	depart
设备自动恢复	reason
设备检修停电倒闸	reason
信号电源突发异常情况	name
信号电源停电	name
首阳农电所	depart
负荷调整停电	reason
地方电源停电	name
永济供电公司	depart2
电源线停电检修	reason
东野	locale
农电	locale
岚县供电局	depart
二路电源线停电	name
线路绝缘子放电	reason
龙马站	locale
龙马配电室	depart
洪洞北	locale
龙马	locale
洪洞县供电支公司	depart
南步亭变电站	depart
刘家垣变电站	depart
变压器后备保护跳闸	name
电源线失压跳闸	name
自闭线路失压跳闸	name
变压器边相线包有烧损痕迹	name
电气化保定变压器有限公司	depart
洪洞北网电工区	depart
龙马配电室	depart2
变压器内部故障	reason
变压器管理不善	reason
侯马北供电段	depart2
虞乡站	locale
永济市供电公司虞乡变电站	depart
二路信号电源停电	name
二路信号电源恢复供电	name
一路贯通电源供电正常	name
虞乡站行车室	depart
永济站信号楼	locale
线路故障停电	reason
端氏站	locale
接触网异物	name
端氏网电工区	depart
段供电调度指挥中心	depart
恶劣天气	reason
社科站	depart
二路电源停电	reason
岚县供电局	depart2
辛庄站	locale
闻喜供电支公司	depart
闻喜站行车室	depart
停电检修	reason
闻喜供电支公司	depart2
原平配电室	depart
五台山供电车间	depart
原平供电车间	depart
原平电力综合工区	depart
枣林电力综合工区	depart
线路跳闸	reason
应急预案	depart
两路电源供电	depart
运城配电室	depart
闻喜供电公司	depart
郭家庄变电站	depart
运城市供电公司	depart
运城地区西环线	locale
线路失压跳闸	reason
电源电压波动异常	reason
线路瞬间失压停电	name
段调度指挥中心	depart
一路信号电源停电	name
运城供电公司	depart2
阳泉曲站	locale
孝西	locale
孝西配电室	depart
山西汾西矿业集团	depart
白璧关网电工区	depart
柳湾煤矿配电室	depart
地方电业局停电	name
电源故障停电	reason
山西汾西矿业集团	depart2
解县供电公司桃园10kV变电站	depart
店坡站	locale
双杆变台被塑料薄膜缠绕	name
相间短路	name
塑料薄膜被大风刮至双杆变台短接变压器	reason
解县电力工区	depart
雨雪冰冻灾害	name
播明	locale
忻口	locale
唐林岗站	locale
忻州配电室	depart
失压跳闸	name
忻州配原平	depart
自闭柜失压跳闸	name
原平站行车室	depart
忻口站电务部门	depart
忻州信号专柜短时停电	reason
信号机处接触网上挂有塑料布	name
吊弦承力索及接触线线夹间缠绕塑料膜	name
太原东站	locale
接触网承力索有塑料布	name
吊弦接触线线夹处挂有一处白色塑料膜	name
太原东站行车室	depart
大风将塑料膜吹起搭落在承力索上	reason
日太北枢纽联一线	depart
汾河接触网工区	depart
信号机处上方接触网挂塑料袋	name
太原北供电车间	depart
太原北一场行车室	depart
太原市	locale
大风将塑料袋吹起搭落接触网上	reason
太原南站石太场	depart
长风街	locale
接触网有塑料布	name
段电调	depart
太原南站行车室	depart
遗弃的塑料布吹落网上	reason
机供联控制度	depart
霍州东10kV配电所	depart
霍州市供电公司35KV北关变电站	depart
霍州东网电工区	depart
北关变电站	depart
介休东	locale
临汾市供电公司	depart
变电站故障停电倒闸	reason
综合贯通瞬间失压	reason
电源屏二路电源瞬间停电	name
大西高铁电力	depart
供电处韩阳镇站	depart
设备部门	depart
永济间	locale
风陵渡配电室	depart
永济市供电支公司	depart
二路电源恢复供电	name
永济电力工区	depart
农电所	depart
韩阳镇站行车室	depart
一路电源供电正常	reason
合流站	locale
东赵站	locale
段廷站	locale
芦家庄站	locale
马首站	locale
寿阳配电室	depart
榆次自闭过流段跳闸	name
榆次配电室寿阳自闭备投不成功	name
榆次供电车间	depart
寿阳供电车间	depart
寿阳电力工区	depart
电力一路电源短时停电	name
榆次电力综合工区	depart
异物瞬间侵限导致自闭线路跳闸	name
太原供电段设备管理不到位	reason
电力运行非正常等突发情况	name
洪洞	locale
虞乡	locale
端氏	locale
辛庄	locale
王董堡	locale
阳明堡	locale
代县	locale
唐林岗	locale
合流	locale
东赵	locale
段廷	locale
芦家庄	locale
马首	locale
2DG红光带故障	name
ATP不接码控停故障	name
ATP故障	name
ATP黑屏导致停车故障	name
ATP控停	name
ATP控停故障	name
ATP信息丢失、数据异常	name
ATP信息丢失、数据异常事故	name
CIR电台故障	name
CIR故障	name
CIR紧急呼叫	name
CTC终端调监黑屏故障	name
D21类事故	name
DJ1不闭合故障	name
FAS集中机故障	name
GYK故障	name
HXD1-72（外转）故障	name
IIG轨道电路故障	name
KSAZ故障启动热备	name
LKJ不接码D21事故	name
LKJ不接码延时机车故障	name
LKJ信号无显示	name
S1LQG占用丢失故障	name
SG进站信号机故障	name
SG三接轨红光带	name
TDCS-A机显示不正常故障	name
TDCS系统故障	name
TDCS协转故障	name
抱闸拦停	name
抱闸停车	name
本务机车调车挤岔事故	name
闭塞机无法复原	name
闭塞设备电源停电	name
变电所跳闸	name
玻璃破损	name
不解锁遗留白光带	name
车辆不缓解	name
车辆脱轨	name
车辆异音	name
车辆预报强热	name
车辆制动不缓解	name
车辆走行部冒火花	name
车轮冒火花	name
车门问题	name
从控机车渡板变形	name
错误发出299组呼事故	name
大风报警	name
倒树	name
道岔岔后塌坑	name
道岔定位无表故障	name
道岔定位无表示	name
道岔定位无表示故障	name
道岔反位失表故障	name
道岔反位无表示故障	name
道岔封锁	name
道岔封锁整修	name
道岔红光带故障	name
道岔晃车	name
灯丝报警	name
电缆槽盖板搭在桥梁护栏上	name
电缆中断事故	name
电力电源瞬间停电	name
电力电源停电	name
电力停电故障	name
电路绿光带故障	name
电台失效故障	name
电务天窗延点	name
电线侵限	name
动车所线路下沉故障	name
动车组HMI屏报前开闭机构未闭合	name
动车组车门故障	name
动车组齿轮箱渗油	name
动车组故障	name
动车组跳主断	name
动车组停车	name
动车组无高压停车	name
动车组无网压	name
动车组闸片脱掉块	name
动车组制动不缓解	name
动车组制动故障	name
动车组制动无法施加故障	name
动车组主断跳开	name
堵车影响行车	name
渡板变形	name
断缝拉开	name
断轨	name
断轨（焊缝拉开）故障	name
发现行人	name
反位失表	name
防路外	name
防路外非常停车	name
防路外紧急停车	name
防路外停车	name
防路外停车越过分相运行	name
防止路外	name
防撞行人	name
防撞行人非常停车	name
防撞行人停车	name
防撞羊群停车	name
封锁	name
封锁线路	name
钢轨伤损	name
钢轨损伤	name
钢轨折断	name
钢轨重伤	name
高铁晃车	name
隔离开关遭雷击	name
更换本务机车	name
轨道电路红光带	name
轨道电路红光带故障	name
轨道衡下沉	name
轨道区段红光带故障	name
轨左股钢轨折断	name
行李车拉门	name
行李车拉门故障	name
行人抢道防撞停车	name
红光带、三友控制台黑盘	name
红光带D21事故	name
红外线预报强热	name
呼叫停车	name
护坡溜塌事故	name
护网内有两只羊	name
护网外焚荒	name
护网外烧荒	name
击碎玻璃	name
机车CIR电台发生故障	name
机车LKJ显示器事故	name
机车LKJ信号无显示事故	name
机车玻璃破损	name
机车不接码故障	name
机车车顶放炮	name
机车车顶异音	name
机车发生故障	name
机车分解	name
机车风泵加油	name
机车故障LKJ截屏	name
机车故障导致分路不良	name
机车故障事故	name
机车故障停车	name
机车故障停车救援	name
机车刮弓	name
机车区间停车	name
机车设备故障	name
机车受电弓被刮	name
机车铁鞋丢失	name
机车停车	name
机车信号掉码	name
机车信号故障	name
机车信号灭灯	name
机车信号突变故障	name
机车信号无码故障	name
机车信号无码造成停车	name
机车信号显示红灯	name
机车信号显示红灯故障	name
机车信号由双黄码掉白码	name
机车与行人刮蹭停车	name
机车主断跳闸	name
机车自动上闸故障	name
机车走行部圆弹簧断裂	name
机车左侧小打开	name
计算机联锁设备报警	name
加挂验车未开折角塞门	name
降雨封锁	name
降雨警戒	name
降雨限速	name
降雨限速封锁	name
交通事故	name
接触网承力索断线事故	name
接触网承力索固定杆脱落侵限	name
接触网吊弦脱落	name
接触网吊弦脱落故障	name
接触网断线	name
接触网挂有异物	name
接触网冒火花	name
接触网上异物	name
接触网跳闸故障	name
接触网停电	name
接触网网压高	name
接触网支柱塌陷	name
紧急呼叫	name
紧急制动停车	name
进站信号机故障	name
客车路外事故	name
客列紧急停车	name
控停故障	name
拦停	name
离去红光带	name
联锁设备报警	name
联锁设备报警故障	name
列车不保压	name
列车查询不到尾部风压	name
列车冒烟	name
列车异音	name
列车占用丢失报警故障	name
列尾查不到风压故障	name
列尾风压乱变	name
列尾风压异常	name
列尾故障	name
列尾自动减压	name
列尾自动排风	name
路基下沉	name
路外事故	name
铝热焊缝拉开	name
冒火星	name
煤冒烟	name
内护坡焚烧	name
偏重问题	name
汽车刮蹭	name
牵引变流器切除	name
牵引故障	name
强热	name
桥头护锥冲毁问题	name
桥头下沉	name
芹泉夹板单折	name
区间停车	name
区间停车退行	name
区间移频报警	name
区间作业车异响停车	name
全站停电及联锁显示器无显示	name
热轴故障	name
人工有感晃车	name
熔丝断丝报警故障	name
融雪装置异常	name
闪红光带故障	name
受电弓刮弓	name
水管破裂水流射向接触网	name
水害	name
水漫线路	name
瞬间红光带	name
塌坑	name
太中银线电源屏报警	name
太中银线弓网故障	name
调车挤岔	name
调车列车辆漏风	name
调车信号机非正常关闭故障	name
调度呼停	name
铁路交通一般D21类事故	name
停车检查机车走行部	name
停电报警	name
通信故障	name
脱轨事故	name
挖断电缆事故	name
挖断信号电缆	name
晚开车	name
网络系统故障	name
网压不稳	name
网压异常	name
微机显示屏花盘	name
无人看守道口防撞机动车	name
无人看守道口撞汽车	name
下行挂板抢修	name
限速	name
线接触网跳闸	name
线路红光带故障	name
线路下沉故障	name
线路有树	name
信号电缆中断	name
信号电缆中断事故	name
信号机不能开放故障	name
信号机灯丝报警	name
信号机故障报警	name
信号机灭灯事故	name
信号机闪红	name
信号突变故障	name
烟火报警	name
延误列车	name
移频故障	name
异物侵限停车	name
异响停车	name
因机车故障停车救援	name
鱼尾板单折	name
占用丢失	name
占用丢失报警	name
占用丢失报警故障	name
占用丢失故障	name
折作业漏泄超标	name
整体道床离缝	name
制动抱闸	name
制动故障	name
制动管破裂故障	name
制动软管破裂	name
主管漏风	name
柱上断路器跳闸	name
撞狗停车	name
撞汽车	name
撞人停车	name
撞人停车交通事故	name
自动降弓	name
自律机报警故障	name
04435AG接收器特性不良	reason
11DG防护盒特性不良	reason
15DG与27-29DG之间的绝缘被短路	reason
16CP模块故障	reason
219QA断路器热态工作性能不稳定	reason
27K09接触器卡滞	reason
3GA组合TZ2架XFJF2继电器62端子至侧面端子板505-3端子内部配线虚断	reason
AEI天线盒绝缘性能下降	reason
APU1、APU2过滤器污损	reason
ATP控停	reason
ATP控制组匣对BTM主机供电不稳定	reason
ATP主系WDOU板故障	reason
AX模块插头插针存在接触不良	reason
A相电压波动且超出报警上限	reason
BCUX10板卡故障	reason
CI2控制单元基板内部变换器温度异常	reason
CI2控制单元与微机主机的通信异常	reason
CIR设备死机	reason
CIR主机TDCS数据接口内解码电路故障	reason
CPU板内部故障	reason
D4电机电压传感器故障	reason
DJ1的闭合线圈和保持现圈不能正常得电	reason
EBV电子制动阀本身发生“085-EBVCN失效（EBV）”故障	reason
E型密封圈龟裂瞬间漏风	reason
FSK板工作不稳定	reason
II系联锁机死机	reason
I系驱采机驱动板故障	reason
LCU2电源板故障	reason
MB03B板卡导致网络显示故障	reason
MON报油流故障	reason
OCU故障	reason
OCU主备用端无故发生IMSI去附着	reason
Q101交流开关故障	reason
QFJ继电器接点接触不良	reason
RIM模块中的K2继电器故障	reason
SIPM故障	reason
SZ1JG2受端10A断路器性能不良	reason
TAL集成仪表箱故障	reason
TAL检测异常线电压信号反馈给CLT	reason
TCU2内部24V电源板故障	reason
TCU2内部电源板故障	reason
TDCS/CTC通道出现误码	reason
TDCS/熔丝报警模块故障	reason
TDCS的AIO2000板中的电子盘特性不良	reason
TDCS设备机柜中液压断路器开关掉落	reason
TDCS协议转换器工作状态不稳定	reason
UPS性能不良	reason
UPS与电源屏监测通讯异常	reason
V43机械控制阀作用不良，出现偶发卡滞	reason
X-IPM模块故障	reason
XL1信号机红灯主灯丝断丝	reason
YC接触器电机电磁兼容器电路板线路烧断	reason
安全宣传不到位	reason
安全隐患排查不到位	reason
安全隐患排查整治不到位	reason
摆臂下滑轮与车门下滑道卡滞	reason
半自动缓解阀膜板破损	reason
暴雨天气	reason
备系TCR板故障	reason
本柜过流跳闸	reason
泵电机冷却风扇运行中有时卡滞	reason
扁铜管于散热片焊接处漏水	reason
变电所遭到雷击	reason
变电站电源调整负荷停电倒闸	reason
变电站电源线故障	reason
变电站供电故障停电	reason
变电站开关故障跳闸	reason
变电站南线停电倒闸	reason
变电站停电处理缺陷	reason
变电站系统电压波动	reason
变电站系统失压	reason
变电站支线停电	reason
变换器温度异常	reason
变压器电缆头故障	reason
变压器电死老鼠	reason
变压器内部气压过大	reason
补偿限制管上部与限制肩架连接螺栓紧固不牢	reason
残压瞬间超标	reason
操纵节劈相机扳钮开关凸轮顶片断裂	reason
操纵节劈相机接触器动静触头闭合超程小	reason
操纵节压缩机接触器动静触头过热烧损、接触不良	reason
操纵节中间继电器联锁接触不良	reason
岔前轨距杆与主机安装装置托板相碰形成单边短路	reason
柴油机缸活塞伞裙掉块	reason
柴油机滑油压力低于限值	reason
柴油机左侧凸轮轴与配气齿轮连接的法兰根部疲劳断裂	reason
车窗外层玻璃破损	reason
车顶放电间隙存在锐角	reason
车顶绝缘检测值较低	reason
车顶绝缘子表面清洁不彻底	reason
车辆高磨合成闸瓦与车轮踏面长时间摩擦	reason
车辆空气制动故障	reason
车辆脱线	reason
车辆异常出闸	reason
车门关闭不严	reason
车站值班员应急处置不力	reason
车智能显示器故障	reason
乘务员在列车运行中误听到机车下部有异音	reason
齿冠断裂横断面存在疲劳裂损现象	reason
齿轮齿冠断裂横断面存在疲劳裂损现象	reason
齿轮箱填充物部分外漏	reason
触发机车断钩保护动作	reason
触头电弧熔焊粘连	reason
传动轴产生局部裂损	reason
传感阀安装面有多余橡胶垫残留	reason
大风	reason
大风将广告牌刮于护网内	reason
大风天气	reason
当事人横越线路	reason
道岔别劲卡阻	reason
道岔不能操到反位	reason
道岔岔后切割绝缘短路	reason
道岔岔后西股绝缘内部有铁屑短路	reason
道岔导曲线下股绝缘接头两侧钢轨顶面存在鱼鳞伤	reason
道岔第一块滑床板上有煤渣	reason
道岔第一连接杆铁绝缘垫破损形成单边短路	reason
道岔定位尖轨与基本轨间滑床板上夹有煤块	reason
道岔定位密贴过紧	reason
道岔定位密贴锁闭时发生卡阻	reason
道岔反位表示缺口小、卡口	reason
道岔反位尖轨第一块滑床板尖有煤渣	reason
道岔反位锁钩紧不解锁	reason
道岔副机反位表示缺口变小卡口	reason
道岔副机反位侧勾头与锁闭铁间有铁渣	reason
道岔副机油缸反窜	reason
道岔副机油缸内部阻塞	reason
道岔滑床板卡入石砟	reason
道岔基础软硬不一	reason
道岔挤岔板别劲	reason
道岔尖轨上翘，尖轨落不到基本轨槽	reason
道岔尖轨与基本轨之间夹冰块	reason
道岔融雪变压器一个输出空气断路器断开	reason
道岔主机定位侧密贴紧	reason
道岔主机定位侧缺口变无	reason
道岔主机定位侧缺口变小、卡阻	reason
道岔主机反位侧缺口变无	reason
道岔主机启动油缸内部活塞密封圈破裂	reason
道岔主机自动开闭器静接点片氧化接触不良	reason
道岔转换不到定位	reason
道岔自动开闭器动、静接点接触不良	reason
道岔左尖轨跟端夹板及间隔铁经长期运营磨耗	reason
道床漏泄大	reason
道床煤面多漏泄大	reason
道床排水不良	reason
道床污染板结	reason
道床污染排水不畅	reason
道床污染严重	reason
道床线积煤且有防冻液	reason
道口两侧线路片石挡墙封堵	reason
低电压动作跳闸	reason
低温恒温元件失效	reason
低压跳闸停电	reason
地方电源进线故障失压	reason
地方供电公司故障停电	reason
地方供电公司停电	reason
地方供电系统短时间电源质量轻微波动	reason
地势较低	reason
第一牵引电机主级绕组大线与电机外壳接磨	reason
第一撒砂电空阀出现失电后不释放的卡滞现象	reason
第一速度传感器故障	reason
电磁阀及压力传感器检测指标范围	reason
电负荷未均匀分配	reason
电抗器故障	reason
电缆故障	reason
电缆径路上外露	reason
电缆质量存在缺陷	reason
电缆中间头发生短路故障	reason
电力杆拉线被机动车辆刮碰	reason
电路设计IVAG不发码	reason
电台天线驻波比超标	reason
电台音量旋钮发生偏转	reason
电务维修机工控机电源故障	reason
电务维修机内部板卡接触不良	reason
电务维修机死机	reason
电压超出二次端子额定值	reason
电源板故障	reason
电源侧所变I由于存在质量缺陷发生故障	reason
电源电压波动	reason
电源短时停电	reason
电源接地跳闸	reason
电源屏TDCS/熔丝报警模块故障	reason
电源屏电源模块瞬间保护无输出	reason
电源屏监测模块与电源屏UPS2通讯不同步	reason
电源失压跳闸	reason
电源失压停电	reason
电源适配器故障无电压输出	reason
电源线失压跳闸停电	reason
电源线线路临时性停电	reason
电源因雷击瞬间失压	reason
电源遭雷击	reason
电子柜A组CPU插件故障	reason
电子盘特性不良	reason
动车组列车底部结有冰块	reason
动车组列车在站停留期间如何开门规章没有规定	reason
动作阀杆衔铁气隙小	reason
冻煤掩埋钢轨	reason
读取尾部风压值不准	reason
渡板边角与车体相撞	reason
渡板位移超过位移极限值	reason
渡板与车体碰撞	reason
短路	reason
短路道岔跳线	reason
短路故障跳闸	reason
短路跳闸停电	reason
短路虚接	reason
短时停电	reason
段修后首趟运行产生的运转热	reason
断电降弓	reason
断路器热态工作性能不稳定	reason
断路器性能不良	reason
对调速器最低转速调整螺钉紧固不良	reason
扼流线安装不规范	reason
二电源失压跳闸	reason
二端后视镜风管裂损	reason
二柜速断	reason
二回线故障停电	reason
二路地方农电电源停电	reason
发码继电器自闭电路被切断	reason
阀口关不严	reason
法兰接头的两个连接端面不对中，存在别劲现象	reason
法兰接头的两个连接端面存在别劲现象	reason
防护盒特性不良	reason
防鼠隐患排查整治不到位	reason
防脱挂板固定螺丝开口销与表示杆相碰	reason
防脱拉环变形	reason
防脱装置拉环与车轴下部发生触碰	reason
放电造成跳闸	reason
分段绝缘器一直处于耐压状态	reason
分支杆变台线路中相与贯通线边相安全距离不足	reason
风泵接触器吸合不能释放	reason
风险研判不到位	reason
辅发电流增大	reason
辅助变流器隔离	reason
辅助回路、控制回路接地	reason
负荷侧故障	reason
干线电缆故障	reason
钢轨肥边打磨处理不及时	reason
钢轨轨面存有不规则黑色片状压物	reason
钢轨轨面生锈	reason
高压柜接触器有大线从线鼻内脱出	reason
高压接触器KSAZ31故障	reason
隔层腔室内积水	reason
隔离开关动、静触头间连杆弯曲	reason
隔离开关主刀闸绝缘子底座传动轴内部轴承破损	reason
更换钢轨施工后分路不良	reason
供电部门日常设备检修不到位	reason
供电部门日常设备巡视不认真	reason
供电系统短时间电源质量轻微波动	reason
供电线路进行负荷调整	reason
固定电台音量旋钮的胶圈松动	reason
固定螺栓不同程度的产生松动	reason
故障判断及处置不到位	reason
贯通杆被路外汽车撞断	reason
广告牌加固不牢	reason
轨道电路残压超标、分路不良	reason
轨道电路电压异常波动	reason
轨道电路短路	reason
轨道电路漏泄大	reason
轨道衡绝缘破损	reason
轨道煤粉多，漏泄大	reason
轨道区段轨道衰耗器特性不良	reason
轨道区段送电端与受电端相邻处轨道绝缘被疑似列车掉落的铁屑短路	reason
轨端绝缘被外界金属片短路	reason
轨端剖切面不平整	reason
轨距杆绝缘降低	reason
轨距水平超经常保养标准	reason
轨面表层产生与列车运行方向一致的细小表层裂纹	reason
轨面生锈	reason
轨面有锈	reason
轨头内侧下颚部位产生一重伤疲劳源	reason
轨腰下圆弧与轨底过渡处溢流肥边打磨不彻底	reason
轨枕空吊	reason
过流Ⅰ段跳闸	reason
过流跳闸	reason
焊缝处存在低塌	reason
焊缝处后轨枕无垫板	reason
焊缝处线路动态不平顺	reason
焊缝处有核伤	reason
焊缝轨底处焊筋边缘有气孔	reason
焊缝强度不足	reason
焊缝探伤	reason
行车设备故障	reason
行人抢越道口线路	reason
行人违法闯入线路	reason
行人在铁路线路上行走、坐卧	reason
行人在未设平交道口、人行过道的铁路线路上通过	reason
行为人驾驶挖掘机清理垃圾将信号电缆挖断	reason
行为人与高速运行的列车车辆碰撞致死	reason
滑轮防脱限位轮外径较小	reason
回路速断跳闸	reason
汇水面积广	reason
活结箍维修紧固不到位	reason
活塞与缸套间的气密性不严	reason
货运隔离开关一直未闭合	reason
机班两人互控不到位	reason
机车34-Q05自动开关热过载保护故障	reason
机车-4位速度传感器故障	reason
机车BCURS422板卡故障	reason
机车BCUX10板卡故障	reason
机车BPCP内部节点故障	reason
机车CPM模块故障	reason
机车EBV模块故障	reason
机车EBV内部节点不良	reason
机车ERCP故障	reason
机车LCDM故障	reason
机车LOCOTROL系统扩展的集成处理器模块X-IPM故障	reason
机车MPU1故障	reason
机车PSV1/PSV2故障	reason
机车TCU1G019插件内部故障	reason
机车TCU2L095插件故障	reason
机车柴油机活塞掉块	reason
机车单位时间撒沙量大于规定的技术标准	reason
机车单元制动器出现缓解不到位、卡滞的情况	reason
机车的辅变流系统中的控制单元ACU1故障	reason
机车电机电压传感器故障	reason
机车电源柜稳压触发插件故障	reason
机车电子制动阀故障	reason
机车渡板边角与车体碰撞	reason
机车端子柜端子排线路接触不良	reason
机车端子柜内部插头进水	reason
机车发生TMC-3板故障	reason
机车非正常撒沙	reason
机车风泵接触器烧损	reason
机车风泵温度传感器故障	reason
机车高压柜电控阀线鼻子压接不良	reason
机车高压柜空载试验闸刀辅助联锁不良	reason
机车和接触网间产生高次谐波，进而发生谐振	reason
机车和接触网间产生高次谐波、谐振	reason
机车集成处理器模块X-IPM故障	reason
机车均衡风缸控制模块故障	reason
机车拉门上滑道外翻变形	reason
机车列尾控制盒主控板解码错误	reason
机车牵引隔离	reason
机车水温高	reason
机车司机室显示模块故障	reason
机车速度传感器故障	reason
机车通风机绕组接地	reason
机车网压表显示接触网失压	reason
机车网压检测回路的高压互感器输出模块故障	reason
机车微机系统运行异常	reason
机车无压无流	reason
机车小闸接线板固定螺丝松动	reason
机车信号感应线圈处于分界绝缘处	reason
机车信号故障	reason
机车信号机感线圈之间电缆通道断线	reason
机车信号机上行信号线和下行信号线绝缘不良	reason
机车信号接收线圈跨过绝缘断面	reason
机车信号主机电源板模块老化，性能下降	reason
机车信号主机设备不稳定	reason
机车信号主机异常	reason
机车液压油泵内部柱塞断裂	reason
机车右侧单元制动器出现缓解不到位、卡滞的情况	reason
机车整备作业标准化落实不到位	reason
机车制动补风系统存在异常	reason
机车制动控制单元RS422板卡故障	reason
机车制动显示屏本身故障	reason
机车质量风险研判不到位	reason
机车智能显示器故障	reason
机车重联中间继电器有毛刺	reason
机车主断路器电磁阀线圈内部断路	reason
机车主逆1水压传感器故障	reason
机车主逆水压传感器故障	reason
机车自动过分相装置连续误动作	reason
机械室防鼠检查不到位	reason
基本防混措施不采取	reason
集成仪表箱故障	reason
集中监测信号机灯丝电流异常	reason
继电器板卡存在异常	reason
继电器瞬时故障	reason
继电器震动接点粘连	reason
尖轨与基本轨密贴紧道岔操不到底	reason
检修质量把关不严	reason
减压停车	reason
降压站故障掉闸	reason
降压站临时负荷调整	reason
降压站母线电压波动	reason
降压站瞬间失压停电	reason
降压站系统停电	reason
降雨导致雨水蓄积导电	reason
降雨量大	reason
胶接绝缘不良	reason
胶结绝缘内部性能不良	reason
胶泥缓冲器芯子出现胶泥泄漏	reason
焦炭掉落在道岔反位侧尖轨与基本轨间滑床板间	reason
接触器动静触头闭合超程小	reason
接触器动静触头接触电阻增大	reason
接触器卡滞	reason
接触网存在覆冰、结霜现象	reason
接触网导线覆冰严重	reason
接触网回流干扰	reason
接触网上有塑料布	reason
接触网设备状态不良	reason
接触网瞬间跳闸	reason
接触网线岔支下锚与工作支接触线抬高不足	reason
接触网支柱基础塌陷	reason
接线破损与外壳接磨	reason
解码电路故障	reason
进站信号机红灯主副灯泡双断丝	reason
绝缘及连接线异常	reason
绝缘接头轨端断面不垂直且存在毛刺	reason
卡箍固定螺栓脱落	reason
卡阻现象	reason
开关状态不良	reason
可控列尾主机产生均缸减压	reason
客车机故障	reason
客列尾装置发生故障	reason
空转保护插件故障	reason
控制板输出一个制动控制器在紧急位的信号	reason
控制阀主阀内部存在铜屑、杂质	reason
控制阀主阀主活塞螺母松动	reason
控制盒故障	reason
控制回路接地	reason
控制系统将故障节机车主断受电弓封锁	reason
雷击导致10KV电力自闭、贯通线路相继跳闸停电	reason
雷击造成线路跳闸	reason
雷雨	reason
雷雨大风天气	reason
雷雨恶劣天气	reason
雷雨天气	reason
冷却风速传感器故障	reason
励磁机故障	reason
连续降雨	reason
联锁机CPU板与系统控制板故障	reason
联锁机死机	reason
联锁设备报警	reason
列车管不明原因快速下降	reason
列车管控制模块故障	reason
列车管压力空气波动	reason
列车管折角塞门阀芯与铜套研磨不好	reason
列车接入反向载频HU码停车	reason
列尾电池与主机电池接线柱接触不良	reason
列尾电台主机发射功率偏低	reason
列尾主机电池内部串联电池组负极焊点虚接	reason
列尾主机内置电台功放块虚接	reason
列尾主机压力传感器故障	reason
列尾主机压力传感器状态不良	reason
列尾主机与电池接触不良	reason
列尾主机主控板主控板芯片接收处理压力传感器读取的尾部风压数据不正确	reason
零压保护装置时间继电器286KT400地线松动	reason
零压保护装置时间继电器地线松动	reason
零压时间继电器286KT作用不良	reason
路基部分下沉	reason
路基防护设施状态不良	reason
路基松软	reason
路基土体含水量饱和	reason
螺栓扣压力不足	reason
旅客行李箱阻碍车门关闭	reason
盲目移动车列	reason
煤尘堆积	reason
煤尘掩埋道床	reason
煤炭长时间堆存缓慢氧化	reason
煤渣堆积遇降雨	reason
煤渣洒落线路	reason
煤渣洒落线路未及时清理	reason
密封圈的磨损	reason
密封圈内部结构损坏	reason
密封作用不良	reason
母线接地	reason
内部扁铜管于散热片焊接处漏水	reason
内部插针短路	reason
内部配线虚断	reason
内部烧损短路	reason
拧紧手闸未松	reason
农电环网柜倒闸停电	reason
农电所负荷调整停电	reason
农用线故障停电	reason
排气阀鞲鞴内套有锈迹	reason
排水沟泄洪量有限	reason
排水设施不全	reason
配电柜感烟探头火灾报警	reason
配电室备电源地方供电公司短时停电	reason
配电室电源失压	reason
配电室二电源失压跳闸	reason
配电室停电	reason
配电室信号线速断跳闸	reason
配电室主电源失压	reason
配件脱落和工具坠落	reason
配速活塞磨损	reason
劈相机启动继电器283AK中的电容烧损	reason
劈相机运行中出现过载保护误动作	reason
启停机电磁联锁DLS失去固定作用	reason
气缸摇臂轴及横臂压球座磨耗超限	reason
汽车驾驶员未执行“一停二看三通过”的规定	reason
牵引变流器及辅助变流器切除	reason
牵引控制单元内部控制程序存在缺陷	reason
牵引无流及主断不闭合故障	reason
牵制鼓牵引低压联锁故障	reason
前增压器检修工艺执行不到位	reason
潜油泵电机接线、油流继电器接线过热	reason
欠压保护	reason
抢越线路	reason
桥面积水时间较长	reason
轻微空转	reason
区段调整电压下降	reason
区间电源屏交流切换板不良	reason
区间发送器电源接点处有氧化现象	reason
曲轴箱超压	reason
燃油调压阀内部密封胶圈过度磨损	reason
人为导致机车撞击	reason
日常设备巡视不到位	reason
日常维修作业存在漏检、漏修	reason
软件存在设计缺陷	reason
塞钉虚接	reason
塞拉门下摆臂受力变形	reason
三跨非绝缘锚段关节下锚接触线第一根吊弦与工作支承力索水平距离不足	reason
擅自进入铁路线路封闭区域	reason
上级变电站停电检修	reason
设备故障短时停电倒闸	reason
设备故障停电	reason
设备漏检漏修	reason
升弓电磁阀异常失电	reason
石碴溅落至岔动作杆处	reason
室内隔离盒性能不良导致	reason
手制动机轴链较紧	reason
受电端箱内D6万科端子插接不良	reason
受电端之间胶结绝缘右股外侧特性不良	reason
受电弓被飞鸟撞击	reason
受电弓带电部分与车体发生接地短路	reason
受电弓弓头前后滑板过梁处存有裂纹	reason
受电弓滑板底部内测存在疲劳裂损	reason
受电弓滑板与接触网导线接触不良	reason
受电弓前弓头供风管接头遭飞鸟撞击断裂漏风	reason
受电弓升弓高度不够	reason
受电弓一位侧平衡杆软连线安装端子与上臂转轴存在抗磨现象	reason
树枝搭在接触网正馈线与保护线上	reason
树枝短接斜腕臂绝缘子	reason
树枝刮碰导线	reason
树枝侵限车顶	reason
衰耗器特性不良	reason
水泵水封卡环变形	reason
水管年久失修开裂跑水	reason
瞬间电流大	reason
瞬间掉码	reason
瞬时性故障	reason
司机控制器零位联锁418-411动作卡滞	reason
司机在机车清洁时误碰机车CIR紧急呼叫键	reason
司机主动减压	reason
司控器手柄故障	reason
私自使用挖掘机在铁路安全保护区内进行挖土作业	reason
死者违法进入铁路线路	reason
死者在铁路线路上行走	reason
送电端与受电端相邻处普通绝缘内部有铁屑	reason
速度传感器接线盒插座故障	reason
塑料薄膜被大风刮上双杆变台	reason
塑料薄膜刮到了接触网上	reason
塑料袋挂在接触网定位装置上	reason
塑料膜搭落在承力索上	reason
塑料膜搭落在接触网上	reason
隧道施工	reason
锁框固定螺栓与表示杆相碰	reason
探伤漏检	reason
填土不密实	reason
调速器最高转速止钉固定销窜出后脱落	reason
调整制动缸鞲鞴行程时没有兼顾手制动机状态	reason
跳闸	reason
停电处理故障	reason
停电处理缺陷	reason
停放制动软管受外力打断	reason
头尾车信号受干扰	reason
投光灯低压回路私自使用大功率电器	reason
途中撞狗停车	reason
土质路基部分下沉	reason
脱轨制动阀球阀连接法兰安装不正位、偏压	reason
脱轨自动制动装置阀杆折断	reason
外电网电源供电质量不高	reason
外门感应胶条受到障碍物的挤压触发了感应胶条	reason
外网II路A项电压超出自动闭塞信号变压器二次端子额定值	reason
晚出勤	reason
网络显示故障	reason
网压回路继电器21-A10-K02触点不良	reason
网压瞬时波动	reason
微机联锁AUPS不间断电源特性不良	reason
微机联锁不间断电源特性不良	reason
微机系统出现一次误紧急制动信号输出	reason
尾部风压数据不正确	reason
尾部异响	reason
未对加挂车辆进行“三捆绑”作业	reason
未落实检修作业标准	reason
无法关闭机油回油通道	reason
误报二次谐波滤波感应器过热	reason
误听车辆有异响	reason
雾霾天气	reason
下雨	reason
显示屏通讯丢失	reason
显示器按键不良	reason
线路高低发生变化	reason
线路过流跳闸	reason
线路几何尺寸发生变化	reason
线路两侧垃圾较多	reason
线路两侧路肩高于轨面	reason
线路瞬间故障	reason
线路速断跳闸	reason
线路停电检修	reason
线路相杆顶帽脱落	reason
线路有行人	reason
线头搭接在电控阀安装螺丝上	reason
橡胶模板密封不严	reason
小半径曲线养护的工作标准不高	reason
小闸内部微动开关接线失去固定作用	reason
泄水道泄洪能力不足	reason
卸冻煤洒落道床造成掩埋线路	reason
新筑路基下沉变化大	reason
信号Ⅱ路电源地方电源故障停电	reason
信号II路混合农电电源停电	reason
信号操作终端显示屏黑屏	reason
信号二路电源短时停电倒闸	reason
信号二路电源站变各用电负荷用电瞬间不平衡	reason
信号机电缆盒万科端子电缆线头断	reason
信号机蓝灯点灯单元瞬间快速恢复二极管特性不良	reason
信号机械防鼠封堵措施落实不到位	reason
信号线速断跳闸	reason
信号一路低压电缆损坏	reason
信号一路电源停电	reason
修程机车质量卡控不到位	reason
蓄电池电压传感器故障	reason
蓄电池电压的电压传感器故障	reason
蓄电池接触器过压抑制模块故障	reason
旋转套中下部处断裂	reason
雪片落至钩锁器上，影响道岔操动	reason
巡视制度不落实	reason
压缩机电机三相绕组对地绝缘受到破坏	reason
压缩机电机三相绕组内部过热烧损	reason
烟头引起火灾	reason
沿途THDS异常温升	reason
羊群侵入线路限界	reason
液压断路器开关掉落	reason
液压油泵内部柱塞断裂	reason
异常出闸	reason
异物瞬间侵限导致自闭线路跳闸	reason
异物瞬间影响线路跳闸	reason
抑制开关内部接触不良	reason
译码器特性不良	reason
引接线电流不平衡	reason
隐患整改不到位	reason
油流继电器故障	reason
油流继电器联锁闭合不可靠	reason
油水冷却塔风机轴承配合状态不良	reason
鱼尾板有一处核伤	reason
雨后漏泄大	reason
雨水蓄积导电	reason
语音记录仪适配器故障	reason
预热锅炉出水管接手接触面接触不良	reason
圆簧材质存在质量缺陷	reason
圆簧断裂故障	reason
运转热导致轴温报警	reason
在未设置行人通道的铁路桥梁、隧道通行	reason
闸瓦材质不良	reason
闸瓦材质存在缺陷	reason
闸瓦与车轮间发生异常摩擦	reason
闸瓦与车轮间夹有铁屑等异物	reason
占用S1LQG轨道区段时分路不良	reason
站场柜短时故	reason
站场柜短时故障	reason
站内电源屏A屏M21模块故障	reason
站内电源屏模块故障	reason
整流环节中间电压信号异常	reason
正常晃动误报为晃车	reason
支线故障跳闸停电	reason
直流电机发生短路或接地	reason
制动阀主鞲鞴组成与滑阀座突发卡滞故障	reason
制动器与制动控制单元网络通讯中断	reason
制动软管爆破	reason
制动软管橡胶密封圈接触面存在磨耗	reason
制动手柄圆柱销断裂	reason
制动系统板卡故障	reason
制动系统网络通讯受干扰	reason
制动支管与集成式中间体连接法兰密封胶垫安装不正位	reason
制动指令无法正确发送	reason
中间继电器线路搭接	reason
终端继电器后接点接触不良	reason
轴承大修质量不良	reason
轴承后排滚子组件与外圈内滚道、内圈外滚道配合不良	reason
主断反馈继电器21-A11-K01故障	reason
主断路器保护性分闸	reason
主断母线与变压器风机出风口间绝缘电气间隙低于标准值	reason
主发送器电气特性不良	reason
主阀滑阀及滑阀座研磨质量不高、配合不良	reason
主阀滑阀面附着油泥污垢	reason
主机电源插针模块焊点开焊虚接	reason
主机油缸油管路内部结冰	reason
主机之间的通讯突然中断	reason
主膜板穿孔	reason
主逆柜电压互感器故障	reason
主逆柜内部中间电压互感器内部线圈开路	reason
主逆柜主逆水循环快装接头内部配合不良漏水	reason
助理值班员未第一时间喊停列车	reason
转子叶片破损	reason
装卸造成岩土散落掩埋轨底	reason
撞鸟	reason
自闭电缆状态不良	reason
自闭失压停电	reason
自闭停电	reason
自闭线电缆故障过流跳闸	reason
自闭线过流跳闸	reason
自闭线路过流跳闸	reason
自闭线路速断跳闸	reason
自闭线失压跳闸	reason
自动制动控制器联锁作用不良	reason
组装主管时损坏了密封圈的结构	reason
最高转速穿销固定销安装存在隐患	reason
石太客专前期沿线降雪，线路中的积雪在融化过程中与石碴冻结在一起，形成了受力面积较大的“石碴体”	reason
01端ATP设备列车接口单元（TIU单元）中的HIRM板故障	reason
419号道岔电缆盒至415号道岔电缆盒间D2电缆芯线内部不良	reason
机车A节左侧感应器线圈电缆从根部断线	reason
列尾控制盒故障导致，无法查询风压	reason
无法识别边缘频点1019造成切换失败，下行质差	reason
19号道岔心1定位表示缺口小、卡口	reason
环境温度过高造成	reason
52号道岔定位溢流电流低	reason
Z13（综合架第1排第3架）第6层侧面第1个熔断器电气特性不良	reason
显示器高压板逆变器电容C2虚断导致Q1、Q2烧损	reason
经检查为电源适配器故障无电压输出	reason
800M电台的主机主用通道接收故障	reason
X7信号机XB-2箱盒内万科端子D5（LUH）电缆插接不良	reason
运城北站7道应答器电缆检测盒性能不良	reason
设备超期	reason
枣林站6道煤面、矿粉等掩埋部分轨底，下雨后引起该区段轨道电路泄露大	reason
HXD1-108机车B端车载列尾电台故障	reason
怀仁东站信号II路电源低压行车室(照明)回路电缆故障	reason
解县供电公司桃园10kV变电站馈出地方515电源线停电检修	reason
娄烦配电室二电源地方供电公司大夫庄110KV降压站瞬间失压停电	reason
太原南-北六堡-清徐间贯通线瞬间过流	reason
信号电源供电质量不达标。	reason
太原北一场134号岔前右股绝缘接头轨端处有小舌头，被工字绝缘片上部覆盖，轨端小舌头向下倾斜刺穿工字绝缘片联电	reason
韩阳镇站电源屏报警原因为韩阳镇地方819线路故障停电	reason
吕梁站低压变电亭2号变压器电死老鼠造成馈二、电源二过流I段动作跳闸	reason
地方供电公司原平110kV变电站10kV系统市二线886回路速断跳闸	reason
武乡配电室母联柜过流保护回路时间继电器长期运行震动接点粘连	reason
寿阳供电公司降压站906线干线电缆故障	reason
永济市供电公司王庄35kV变电站母线接地，供电公司进行拉路试验，排查故障	reason
吴城配电所电源上级王营庄35KV变电站因设备故障短时停电倒闸	reason
太原南-北六堡-清徐间贯通线瞬间故障速断跳闸	reason
抚宁北至柳村自闭（后营至柳村区间自闭60#-61#）电缆状态不良短路故障跳闸	reason
平社站二路农电（10kV庄磨514线平社支线）地方供电公司停电	reason
平社站因信号II路混合农电电源停电	reason
永济供电公司首阳镇长旺2#支线因设备检修停电倒闸	reason
永济供电公司35kV王庄变电站馈出首阳镇长旺2#支线因农电所负荷调整停电	reason
解县供电公司桃园10kV变电站馈出515电源线停电检修	reason
解县供电公司桃园10kV变电站馈出515电源线线路临时性停电	reason
龙马配电室1#变压器内部故障	reason
永济市供电公司虞乡变电站853农用线故障停电	reason
闻喜供电支公司35kV郭家庄变电站877道南线停电检修	reason
原平至枣林间贯通Ⅰ线路跳闸	reason
运城配电室2#电源运城供电公司城西541电源电压波动异常	reason
山西汾西矿业集团柳湾煤矿电源故障停电	reason
店坡站附近农田废弃的塑料薄膜被大风刮上贯通109-1#、109-2#双杆变台	reason
忻州配电室二电源（524）失压跳闸	reason
铁路周边遗弃的塑料布因大风吹落网上	reason
霍州市供电公司35KV北关变电站上级变电站故障停电倒闸	reason
原平地区巨风暴雨恶劣天气，崞阳-薛孤20#-21#间10棵大树被飓风刮倒，压断贯通线路上引起跳闸	reason
根据以上情况分析：雷击造成薛孤-梅家庄间91#下锚绝缘子闪络	reason
韩阳站二路电源停电	reason
白彪线	locale
百底站至稷山站间上行线	locale
北同蒲上行线	locale
茶坞线	locale
褚家沟站至吴城站间下行线	locale
大秦下行线	locale
大秦重车线	locale
大同县站至阳原站间下行线	locale
大西动车走行线	locale
大西高铁下行线	locale
大张下行线	locale
岱岳线	locale
东榆林线	locale
东榆林站至袁树林站间下行线	locale
端氏线	locale
段廷站至芦家庄站间上行线	locale
汾太联络线	locale
汾阳线	locale
富家滩线	locale
甘亭-临汾北间下行线	locale
高显-襄汾间上行线	locale
高显站至襄汾站间上行线	locale
古交线	locale
官院站至薛孤站间下行线	locale
崞阳镇-白彪线	locale
崞阳镇线	locale
韩家岭站至大同南站间下行线	locale
洪洞西站上行正线	locale
侯马北Ⅳ场至曲沃站间上行线	locale
侯月上行线	locale
湖东-大同县间重车线	locale
湖东二场至大同县站间下行线	locale
湖东重二线	locale
怀仁线	locale
霍州-南关间上行线	locale
霍州至南关间上行线	locale
焦家寨专用线	locale
介西线	locale
介休站向南铁专用线	locale
金沙滩线	locale
金沙滩站内正线	locale
金沙滩站内转线	locale
金沙滩站至宋家庄站间上行线	locale
京包线	locale
京包线上行线	locale
京沪线	locale
京九线	locale
抗流线	locale
冷泉站至灵石站下行线	locale
灵石冷泉间下行线	locale
灵石—冷泉间下行线	locale
柳林南线	locale
吕梁线	locale
民族站至旗下营站间上行线	locale
南铁专用线	locale
南同蒲上行线	locale
迁安北站至菱角山站间下行线	locale
秦东联络线	locale
秦东信号所至上联线	locale
稍营线	locale
石太场至长风街线	locale
石太客专上行线	locale
石太客专线	locale
隧道纵线	locale
太东线	locale
太南动车上行线	locale
太南动车走行线	locale
太原南动车走行线	locale
太原线	locale
太中线	locale
太中银上行线	locale
唐林岗站上行正线	locale
唐林岗站至原平站间上行线	locale
王滩电厂线	locale
文水线	locale
文水站上行线	locale
吴城站至褚家沟站间上行线	locale
西贺村至侯马间上行线	locale
襄汾-高显间下行线	locale
襄汾站至高显站下行线	locale
忻河支线	locale
新轨上线	locale
修文-榆次间贯通线	locale
轩岗站焦家寨专用线	locale
薛孤线	locale
阳原站至大同县站间上行线	locale
阳原站至化稍营站间下行线	locale
翼城东至桥上间上行线	locale
永济北站上行正线	locale
永济北站至运城北站间上行线	locale
榆次线	locale
榆次站至榆次西站间下行线	locale
原平线	locale
运城北站至永济北站间下行线	locale
张礼-襄汾间下行线	locale
张礼站至临汾站间上行线	locale
张礼站至襄汾站间下行线	locale
长风街线	locale
镇城底站至静游站间上下行线	locale
郑庄线	locale
郑庄至端氏间上行线	locale
郑庄至端氏间上行正线	locale
平社支线	locale
石太线寿阳至榆次间	locale
京原线五台至灵丘间	locale
沁水站至郑庄站间上行线	locale
首阳支线	locale
永康线	locale
榆西线	locale
迁安北线	locale
侯月线郑庄站	locale
北六堡站至清徐站间下行线	locale
吕临支线	locale
介西线孝南站	locale
东会线	locale
北同蒲线韩家岭站	locale
韩家岭站南郊专用线	locale
侯月线南常至翼城站	locale
云支线	locale
大同至同西机走线	locale
原平站至薛孤站间上行线	locale
上兰村支线	locale
岢瓦线	locale
皇太联络线	locale
大张线	locale
包下发线	locale
太原局大秦线	locale
洪洞西站至霍州东站间上行线	locale
石太线寿阳至榆次	locale
石太线寿阳至简子沟	locale
宁岢线秦家庄站	locale
鑫宇专用线	locale
延庆线	locale
涿鹿站至化稍营站间上行线	locale
汾阳站至文水站间上行线	locale
口泉支线	locale
后义线	locale
白文疏解线	locale
崞阳镇至白彪线	locale
侯月线南常站	locale
西高铁下行线	locale
京包线大同北站	locale
北同蒲线皇后园站	locale
闻喜西站至侯马西站间上行线	locale
闻喜西站	locale
义棠至介休间上行线	locale
太原局韩原线	locale
怀仁东至韩家岭间上行线	locale
呼和局包西线	locale
包西线	locale
响沙湾站至达拉特西站间上行线	locale
大秦线北辛堡站至延庆站间下行线	locale
北辛堡站至延庆站间下行线	locale
大西高铁上行线霍州东至灵石东站	locale
大西高铁上行线	locale
霍州东至灵石东站	locale
太岚线	locale
云联线	locale
东港线乐亭站	locale
东港线	locale
大秦线柳村南站	locale
古大联络线	locale
湖大联络线	locale
霍州站	locale
洪洞北站	locale
南寒站	locale
曹妃甸站	locale
妃甸北站	locale
忻州窑站	locale
侯北站	locale
林家口站	locale
京唐港站	locale
灵丘站	locale
西韩岭站	locale
古东站	locale
安塘站	locale
神池站	locale
五寨站	locale
大新站	locale
榆次站	locale
平遥站	locale
崞阳镇站	locale
刘家口站	locale
遵化北站	locale
柏庄村站	locale
半坡村站	locale
华山站	locale
华岩站	locale
介休东站	locale
侯马西站	locale
围聂庄站	locale
义棠站	locale
遥古城站	locale
西属巴站	locale
大石庄站	locale
茶坞车站	locale
徐水东站	locale
抚宁北站	locale
洪洞西站	locale
周家口南站	locale
霸州南站	locale
秦皇岛站	locale
鑫宇煤站	locale
长城梁站	locale
沁水车站	locale
段廷车站	locale
唐子洼站	locale
永济北站	locale
贾庵子站	locale
延庆北站	locale
四台沟站	locale
云冈西站	locale
新高山站	locale
分临北站	locale
下盘石站	locale
白马河站	locale
长畛站	locale
郭磊庄站	locale
安太堡站	locale
大同南站	locale
妃甸南站	locale
水泉南站	locale
万水泉站	locale
魏家滩站	locale
石太南站	locale
蒲州村站	locale
滦南港站	locale
平型关站	locale
清河城站	locale
司家营站	locale
碑店东站	locale
呼和浩特站	locale
李家平站	locale
永嘉堡站	locale
嘉堡车站	locale
嘉堡驻站	locale
吕家滩站	locale
红砂坝站	locale
白羊墅站	locale
陶卜齐站	locale
清凉店站	locale
龙华站	locale
丰润西站	locale
唐山西站	locale
秦皇岛南站	locale
东碾头站	locale
云冈站	locale
阳镇站	locale
蒲县站	locale
寒侧站	locale
楼县站	locale
石楼站	locale
隰县站	locale
同县站	locale
阳原站	locale
仁东站	locale
大南站	locale
韩岭站	locale
临县站	locale
董堡站	locale
吴城站	locale
北周站	locale
浮山站	locale
平谷站	locale
贺村站	locale
泉曲站	locale
晶坪站	locale
郎庙站	locale
角坝站	locale
湾堡站	locale
沟堡站	locale
普明站	locale
柳林站	locale
源屏站	locale
曹西站	locale
林车站	locale
唐之洼站	locale
繁寺站	locale
柳村站	locale
城梁站	locale
白文站	locale
廷车站	locale
济北站	locale
古冶站	locale
庵子站	locale
榆西站	locale
高山站	locale
马河站	locale
万南站	locale
太南站	locale
济西站	locale
州村站	locale
南港站	locale
曹北站	locale
平顺站	locale
榆客站	locale
良乡站	locale
半坡站	locale
沙良站	locale
图定站	locale
龙城站	locale
龙成站	locale
同忻站	locale
韩阳站	locale
万安站	locale
风力作用将塑料薄膜刮到了接触网上	reason
废弃的塑料薄膜被大风刮上贯通109-1#、109-2#双杆变台	reason
口泉	locale
太兴线太北六场	depart
大西线有砟和无砟结合部K281+710	locale
143km+13#轨	locale
大同北站	locale
大秦线湖东二场	depart
北同浦金沙滩站	locale
古交站3-7DG	locale
候阎线	locale
蒲州站、韩阳镇站、首阳站	locale
京原线崞阳镇-白彪线路所间	locale
平遥站至	locale
东观站间	locale
太原局南同蒲线	locale
忻口站	locale
洪洞站至辛堡站间	locale
上行线	locale
运城站	locale
太原局太原站	locale
太原局管内北同蒲线	locale
郝村站至北田	locale
受站间	locale
太原局太焦线	locale
太原铁路局大秦线	locale
太原铁路局北同蒲线	locale
白文东站至白文北	locale
太原局管内南同蒲线	locale
岢瓦专用铁路	locale
太原局太中银线	locale
太原局太原南动车走行线	locale
太中银线柳林南至吴堡间	locale
太原局侯阎线	locale
襄汾站至高	locale
显站间	locale
太原局京包线	locale
太原局东港线	locale
张礼站至临汾站	locale
太原局太北五场	depart
太原局唐林岗-原平区间	locale
太原局大西高铁灵石东站至霍州	locale
东站间	locale
太原清徐站	locale
义棠站至洪善站间	locale
太原局管内侯月线	locale
沁水站至郑庄	locale
太原局平谷至大石庄站间	locale
北六堡站、清徐站、交	locale
城站、文水站、汾阳站	locale
太原局石太线	locale
太原高铁工务段太原南高铁线	locale
洪洞站7-9DG区段	depart
新鸣李站	locale
南同蒲	locale
太原东至太原间	locale
灵石东站4道408km+200m处	locale
忻州站至播明站间上行线	locale
、播明至忻州站间下行	locale
万安站至四公里	locale
津秦线天津上行	locale
曲高联络线曲沃至高显间上行线	locale
下庄至茶坞站间下行	locale
侯马北Ⅳ场至曲沃站间	locale
华岩至集义庄间	locale
原平至灵丘间	locale
灵丘运用车间	locale
太原机务段（北区）至太原北二场间	locale
静游站（含）至娄烦站间上行	locale
化稍营站至涿鹿站间K151处	locale
东淤地站内	locale
柳村南站二场	depart
柳村南站一场	depart
大秦线阳原至化稍营间	locale
北同浦线	locale
大西客专线	locale
西安北大西场站	locale
大中银线	locale
下庄站至茶坞站	locale
茶坞至下庄站	locale
大秦线下庄至延庆	locale
张礼站	locale
大秦线涿鹿至沙城东	locale
轩岗站焦家寨专用	locale
京包线罗文皂至天镇	locale
德阳Ⅱ场	depart
稍营站至涿鹿站	locale
岱岳站至北周庄站	locale
马角坝至二郎庙	locale
太兴线普明至太原北五场	depart
卢龙北站	locale
大同站	locale
太焦线修文-榆社	locale
民族站至旗下营站	locale
唐之洼-灵丘间K239+650M	locale
南关站至冷泉站间	locale
太原北站	locale
长治北站	locale
张礼站至临汾站间上行	locale
太原南动车所	depart
大西高铁13号中继站	locale
南同蒲赵城站	locale
呼和浩特铁路局包兰线	locale
北同蒲线K112+250	locale
义安站	locale
西山支线太原北六场	depart
太原南站石太场至长风街线	locale
路所间石太客专上行	locale
庄儿上站1-5DG轨道电路区段	depart
北京局石德线K175+695处	locale
大西高铁上行右股K412+470	locale
迁西站至迁安北站下行线	locale
K516+138	locale
临汾站15DG、27-29DG轨道区段	depart
甘亭站	locale
长风线路所至太原南石太场石太客专下行线K233+529处	locale
运城至安邑间K748+757	locale
南同蒲下行线K519+840	locale
李家坪同庆专用线	locale
蒲县站至龙马站间下行	locale
寿阳站至芹泉站间	locale
太中银线吕梁山长大隧道内K1075+950-K1075+850	locale
108+190	locale
太原东站4-6DG轨道区段	depart
灵石站至冷泉站间下行线	locale
515km+796m	locale
化稍营-逐鹿站间下行线	locale
湖东二场至大同县站间下行	locale
北同蒲上行线K65+050	locale
沁县站至聂村站间区间153km+652m	locale
路所至太原站间大西上行	locale
红光带	name
全站红光带故障	name
轨道电路闪红光带故障	name
岔封锁整修	name
轨道电路闪红光带	name
区间红光带	name
轨道电路红光带延时	name
K891/4次漏风	name
太原东站4-6DG红光带	name
侯西线侯下段	depart
云岗线	locale
湖大线	locale
邯长线	locale
孝柳线	locale
忻河线	locale
玉门沟线	locale
太中线北中段	depart
武左线	locale
礼垣线	locale
神朔线	locale
武左线武墨段	depart
沁沁线	locale
上兰村线	locale
口泉线	locale
阳涉线	locale
宁苛线	locale
孔庄	locale
灵石	locale
冷泉	locale
富家滩	locale
南关	locale
什林	locale
霍州	locale
圣佛	locale
辛置	locale
沁水	locale
郑庄	locale
田村	locale
上交	locale
罗文皂	locale
王官人屯	locale
大同东	locale
云岗	locale
云岗西	locale
新高山	locale
古店	locale
韩家岭	locale
大同县	locale
华岩	locale
繁峙	locale
下社	locale
解家庄	locale
平社	locale
阳曲	locale
皇后园	locale
陈家沟	locale
长城梁	locale
界牌	locale
安塘	locale
微子镇	locale
潞城	locale
黎城	locale
水洋	locale
漫流河	locale
穆村	locale
两渡	locale
鸣李	locale
甘亭	locale
北义井	locale
定襄	locale
河边	locale
三给村	locale
西张	locale
土堂	locale
柳林河	locale
扫石	locale
古东	locale
东榆林	locale
袁树林	locale
马邑	locale
神头	locale
前寨	locale
坡头	locale
测石	locale
芹泉	locale
上湖	locale
北合流	locale
北营	locale
榆社	locale
台曲	locale
东河	locale
段柳	locale
襄汾	locale
柴庄	locale
高显	locale
侯马北	locale
礼元	locale
东镇	locale
水头	locale
半坡村	locale
解县	locale
孙常	locale
临汾北	locale
北阳	locale
太谷	locale
东观	locale
平遥	locale
祁县	locale
太原西	locale
西阳村	locale
南陈铺	locale
北板桥	locale
东元庆	locale
晋城	locale
西武匠	locale
东坡	locale
吴城镇	locale
堡则	locale
平旺	locale
程家	locale
白羊墅	locale
下盘石	locale
岩会	locale
乱流	locale
赛鱼	locale
凤凰村	locale
太原东	locale
东阳	locale
聂村	locale
魏家坡	locale
横水镇	locale
豆罗	locale
上阳武	locale
夏店	locale
襄垣	locale
五阳	locale
店上	locale
王里堡	locale
大辛庄	locale
小宋	locale
东田良	locale
赵庄	locale
大平	locale
郝村	locale
红崖	locale
牛晶坪	locale
沿寨	locale
路家庄	locale
石会	locale
阳乐	locale
社城	locale
王家会	locale
晋城北	locale
河津	locale
三岔镇	locale
神池南	locale
朔州西	locale
保德	locale
王家寨	locale
阴塔	locale
韩家楼	locale
旧城	locale
北社	locale
新柳	locale
墨镫	locale
开村	locale
新交口	locale
稷山	locale
朱家店	locale
西贺村	locale
新绛	locale
刘村	locale
下迪	locale
百底	locale
离石	locale
东马	locale
柳林县	locale
虒亭	locale
白壁关	locale
东槽	locale
石庄	locale
小景	locale
会沟	locale
三角庄	locale
柳沟村	locale
中阳	locale
镇城底	locale
向阳店	locale
上兰村	locale
高家会	locale
修文	locale
长畛	locale
大牛店	locale
部落	locale
长子	locale
枝柯	locale
五寨	locale
长治北	locale
大同南	locale
岱岳	locale
岢岚	locale
天镇	locale
阳高	locale
阳方口	locale
永嘉堡	locale
周士庄	locale
庄儿上	locale
烟庄	locale
横岭关	locale
夏小堡	locale
义棠	locale
安邑	locale
蒲州	locale
神池	locale
蒋村	locale
张兰	locale
董村	locale
孝南	locale
兑镇	locale
阳泉曲	locale
垣曲	locale
大新	locale
常村	locale
崞阳镇	locale
薛孤	locale
紫寨	locale
平定	locale
宁艾	locale
昔阳	locale
北亩	locale
泊里	locale
石窑坪	locale
东河南	locale
平型关	locale
东淤地	locale
东庄	locale
大营	locale
高平	locale
南峧	locale
东阳关	locale
北舍	locale
娘子关	locale
北庄口	locale
和顺县	locale
寒王	locale
左权	locale
粟城	locale
麻田镇	locale
秦家庄	locale
北周庄	locale
李家平	locale
北田受	locale
辛堡	locale
下湾	locale
洪掌	locale
嘉峰	locale
阳城	locale
五台洼	locale
孤山	locale
堡子湾	locale
洪善	locale
招柏	locale
云彩岭	locale
大涧	locale
长治	locale
聚乐堡	locale
孔庄站	locale
灵石站	locale
富家滩站	locale
南关站	locale
什林站	locale
圣佛站	locale
沁水站	locale
郑庄站	locale
田村站	locale
上交站	locale
罗文皂站	locale
王官人屯站	locale
大同东站	locale
云岗站	locale
云岗西站	locale
古店站	locale
大同县站	locale
集义庄站	locale
下社站	locale
解家庄站	locale
阳曲站	locale
陈家沟站	locale
界牌站	locale
微子镇站	locale
潞城站	locale
黎城站	locale
水洋站	locale
漫流河站	locale
穆村站	locale
鸣李站	locale
北义井站	locale
定襄站	locale
河边站	locale
土堂站	locale
柳林河站	locale
扫石站	locale
东榆林站	locale
袁树林站	locale
马邑站	locale
神头站	locale
朔州站	locale
前寨站	locale
芹泉站	locale
上湖站	locale
北合流站	locale
北营站	locale
台曲站	locale
东河站	locale
段柳站	locale
襄汾站	locale
柴庄站	locale
高显站	locale
东镇站	locale
闻喜站	locale
水头站	locale
孙常站	locale
临汾北站	locale
北阳站	locale
太谷站	locale
东观站	locale
祁县站	locale
西阳村站	locale
南陈铺站	locale
北板桥站	locale
东元庆站	locale
晋城站	locale
西武匠站	locale
东坡站	locale
吴城镇站	locale
堡则站	locale
平旺站	locale
程家站	locale
阳泉站	locale
岩会站	locale
乱流站	locale
赛鱼站	locale
凤凰村站	locale
东阳站	locale
横水镇站	locale
豆罗站	locale
上阳武站	locale
夏店站	locale
襄垣站	locale
五阳站	locale
店上站	locale
王里堡站	locale
大辛庄站	locale
小宋站	locale
东田良站	locale
赵庄站	locale
大平站	locale
风陵渡站	locale
郝村站	locale
红崖站	locale
牛晶坪站	locale
沿寨站	locale
路家庄站	locale
石会站	locale
阳乐站	locale
王家会站	locale
晋城北站	locale
三岔镇站	locale
神池南站	locale
朔州西站	locale
保德站	locale
王家寨站	locale
阴塔站	locale
韩家楼站	locale
旧城站	locale
北社站	locale
新柳站	locale
墨镫站	locale
开村站	locale
新交口站	locale
朱家店站	locale
西贺村站	locale
新绛站	locale
刘村站	locale
下迪站	locale
离石站	locale
东马站	locale
柳林县站	locale
虒亭站	locale
白壁关站	locale
东槽站	locale
石庄站	locale
小景站	locale
会沟站	locale
三角庄站	locale
柳沟村站	locale
中阳站	locale
向阳店站	locale
上兰村站	locale
高家会站	locale
修文站	locale
轩岗站	locale
大牛店站	locale
部落站	locale
播明站	locale
长子站	locale
枝柯站	locale
湖东站	locale
怀仁站	locale
岢岚站	locale
宁武站	locale
天镇站	locale
阳高站	locale
阳方口站	locale
周士庄站	locale
庄儿上站	locale
忻州站	locale
烟庄站	locale
横岭关站	locale
夏小堡站	locale
安邑站	locale
蒲州站	locale
口泉站	locale
蒋村站	locale
张兰站	locale
董村站	locale
孝南站	locale
孝西站	locale
兑镇站	locale
垣曲站	locale
常村站	locale
紫寨站	locale
平定站	locale
宁艾站	locale
昔阳站	locale
北亩站	locale
泊里站	locale
石窑坪站	locale
东淤地站	locale
东庄站	locale
高平站	locale
南峧站	locale
东阳关站	locale
北舍站	locale
娘子关站	locale
北庄口站	locale
和顺县站	locale
寒王站	locale
左权站	locale
粟城站	locale
麻田镇站	locale
秦家庄站	locale
金沙滩站	locale
北田受站	locale
下湾站	locale
洪掌站	locale
嘉峰站	locale
阳城站	locale
五台洼站	locale
孤山站	locale
堡子湾站	locale
洪善站	locale
招柏站	locale
云彩岭站	locale
大涧站	locale
长治站	locale
聚乐堡站	locale
太焦线孔庄站	locale
南同蒲线灵石站	locale
南同蒲线富家滩站	locale
南同蒲线南关站	locale
南同蒲线什林站	locale
南同蒲线霍州站	locale
南同蒲线圣佛站	locale
南同蒲线辛置站	locale
侯月线沁水站	locale
北同蒲线田村站	locale
侯西线侯下段禹门口站	locale
侯月线翼城站	locale
侯月线桥上站	locale
侯月线上交站	locale
京包线罗文皂站	locale
京包线王官人屯站	locale
京包线大同东站	locale
云岗线云岗站	locale
云岗线云岗西站	locale
云岗线新高山站	locale
京包线大同站	locale
京包线古店站	locale
大秦线韩家岭站	locale
大秦线大同县站	locale
京原线金山铺站	locale
京原线五台山站	locale
京原线集义庄站	locale
京原线华岩站	locale
京原线繁峙站	locale
京原线下社站	locale
湖大线解家庄站	locale
北同蒲线平社站	locale
北同蒲线高村站	locale
北同蒲线阳曲站	locale
宁岢线陈家沟站	locale
宁岢线长城梁站	locale
宁岢线界牌站	locale
宁岢线安塘站	locale
邯长线微子镇站	locale
邯长线潞城站	locale
邯长线黎城站	locale
邯长线水洋站	locale
邯长线漫流河站	locale
孝柳线穆村站	locale
南同蒲线两渡站	locale
石太线鸣李站	locale
南同蒲线甘亭站	locale
忻河线北义井站	locale
忻河线定襄站	locale
忻河线河边站	locale
玉门沟线三给村站	locale
玉门沟线玉门沟站	locale
太岚线西张站	locale
太岚线土堂站	locale
太岚线柳林河站	locale
太岚线扫石站	locale
太岚线古东站	locale
北同蒲线东榆林站	locale
北同蒲线袁树林站	locale
北同蒲线马邑站	locale
北同蒲线神头站	locale
北同蒲线朔州站	locale
北同蒲线前寨站	locale
石太线坡头站	locale
石太线测石站	locale
石太线芹泉站	locale
石太线马首站	locale
石太线上湖站	locale
石太线东赵站	locale
石太线北合流站	locale
石太线北营站	locale
石太线太原站	locale
太焦线榆社站	locale
太焦线台曲站	locale
太焦线东河站	locale
太焦线武乡站	locale
太焦线段柳站	locale
南同蒲线临汾站	locale
南同蒲线张礼站	locale
南同蒲线襄汾站	locale
南同蒲线柴庄站	locale
南同蒲线高显站	locale
南同蒲线侯马北站	locale
南同蒲线侯马站	locale
南同蒲线史店站	locale
南同蒲线礼元站	locale
南同蒲线东镇站	locale
南同蒲线闻喜站	locale
南同蒲线水头站	locale
南同蒲线半坡村站	locale
南同蒲线运城站	locale
南同蒲线解县站	locale
南同蒲线孙常站	locale
南同蒲线永济站	locale
南同蒲线韩阳镇站	locale
南同蒲线临汾北站	locale
南同蒲线北阳站	locale
南同蒲线太谷站	locale
南同蒲线东观站	locale
南同蒲线平遥站	locale
南同蒲线义安站	locale
南同蒲线介休站	locale
南同蒲线祁县站	locale
太焦线沁县站	locale
石太线寿阳站	locale
玉门沟线太原西站	locale
石太线榆次站	locale
太焦线西阳村站	locale
太焦线南陈铺站	locale
太焦线北板桥站	locale
太焦线东元庆站	locale
太焦线晋城站	locale
太焦线西武匠站	locale
太焦线东坡站	locale
太中线北中段北六堡站	locale
太中线北中段清徐站	locale
太中线北中段交城站	locale
太中线北中段文水站	locale
太中线北中段汾阳站	locale
太中线北中段吴城镇站	locale
太中线北中段吕梁站	locale
武左线堡则站	locale
北同蒲线平旺站	locale
石太线程家站	locale
石太线白羊墅站	locale
石太线阳泉站	locale
石太线下盘石站	locale
石太线岩会站	locale
石太线乱流站	locale
石太线赛鱼站	locale
太中线北中段褚家沟站	locale
北同蒲线凤凰村站	locale
石太线太原北站	locale
石太线太原东站	locale
南同蒲线东阳站	locale
太焦线聂村站	locale
太焦线魏家坡站	locale
礼垣线横水镇站	locale
北同蒲线豆罗站	locale
北同蒲线上阳武站	locale
京原线唐之洼站	locale
太焦线夏店站	locale
太焦线襄垣站	locale
太焦线五阳站	locale
太焦线店上站	locale
太焦线王里堡站	locale
太焦线大辛庄站	locale
太焦线小宋站	locale
太焦线东田良站	locale
太焦线赵庄站	locale
太焦线大平站	locale
南同蒲线风陵渡站	locale
太焦线郝村站	locale
太焦线红崖站	locale
太焦线牛晶坪站	locale
太焦线沿寨站	locale
太焦线路家庄站	locale
太焦线石会站	locale
太焦线阳乐站	locale
太焦线社城站	locale
孝柳线王家会站	locale
太焦线晋城北站	locale
侯西线侯下段河津站	locale
南同蒲线洪洞站	locale
神朔线三岔镇站	locale
神朔线神池南站	locale
神朔线朔州西站	locale
神朔线保德站	locale
神朔线王家寨站	locale
神朔线阴塔站	locale
神朔线韩家楼站	locale
武左线武墨段旧城站	locale
武左线武墨段北社站	locale
武左线武墨段新柳站	locale
武左线武墨段墨镫站	locale
沁沁线开村站	locale
沁沁线新交口站	locale
侯西线侯下段稷山站	locale
太中线北中段柳林南站	locale
侯月线端氏站	locale
孝柳线朱家店站	locale
侯西线侯下段西贺村站	locale
侯西线侯下段新绛站	locale
侯西线侯下段刘村站	locale
侯西线侯下段下迪站	locale
侯西线侯下段百底站	locale
孝柳线离石站	locale
太焦线东马站	locale
侯西线侯下段清涧站	locale
孝柳线柳林县站	locale
太焦线虒亭站	locale
介西线白壁关站	locale
孝柳线东槽站	locale
孝柳线石庄站	locale
孝柳线小景站	locale
孝柳线会沟站	locale
孝柳线三角庄站	locale
孝柳线柳沟村站	locale
孝柳线中阳站	locale
太岚线镇城底站	locale
上兰村线向阳店站	locale
上兰村线上兰村站	locale
宁岢线高家会站	locale
南同蒲线修文站	locale
北同蒲线长畛站	locale
北同蒲线轩岗站	locale
北同蒲线大牛店站	locale
北同蒲线唐林岗站	locale
北同蒲线忻口站	locale
北同蒲线部落站	locale
北同蒲线播明站	locale
太焦线长子站	locale
孝柳线枝柯站	locale
宁岢线五寨站	locale
太焦线长治北站	locale
大秦线大同南站	locale
北同蒲线岱岳站	locale
大秦线湖东站	locale
北同蒲线怀仁站	locale
宁岢线岢岚站	locale
北同蒲线宁武站	locale
京包线天镇站	locale
京包线阳高站	locale
北同蒲线阳方口站	locale
京包线永嘉堡站	locale
南同蒲线虞乡站	locale
京包线周士庄站	locale
宁岢线庄儿上站	locale
北同蒲线忻州站	locale
礼垣线烟庄站	locale
礼垣线横岭关站	locale
京包线夏小堡站	locale
南同蒲线义棠站	locale
南同蒲线安邑站	locale
南同蒲线蒲州站	locale
京原线代县站	locale
石太线芦家庄站	locale
石太线段廷站	locale
口泉线口泉站	locale
宁岢线神池站	locale
忻河线蒋村站	locale
南同蒲线张兰站	locale
南同蒲线董村站	locale
介西线万安站	locale
介西线孝西站	locale
介西线兑镇站	locale
介西线阳泉曲站	locale
礼垣线垣曲站	locale
北同蒲线大新站	locale
邯长线常村站	locale
京原线灵丘站	locale
京原线阳明堡站	locale
京原线崞阳镇站	locale
京原线薛孤站	locale
京原线原平站	locale
宁岢线紫寨站	locale
阳涉线平定站	locale
阳涉线宁艾站	locale
阳涉线昔阳站	locale
阳涉线北亩站	locale
阳涉线泊里站	locale
阳涉线石窑坪站	locale
京原线东河南站	locale
京原线平型关站	locale
京原线东淤地站	locale
京原线东庄站	locale
京原线大营站	locale
太焦线高平站	locale
邯长线南峧站	locale
邯长线东阳关站	locale
邯长线北舍站	locale
石太线娘子关站	locale
阳涉线北庄口站	locale
阳涉线和顺县站	locale
阳涉线寒王站	locale
阳涉线左权站	locale
阳涉线粟城站	locale
阳涉线麻田镇站	locale
北同蒲线宋家庄站	locale
北同蒲线金沙滩站	locale
北同蒲线北周庄站	locale
宁苛线李家平站	locale
南同蒲线辛庄站	locale
太焦线北田受站	locale
南同蒲线辛堡站	locale
邯长线下湾站	locale
邯长线洪掌站	locale
侯月线嘉峰站	locale
侯月线阳城站	locale
京包线五台洼站	locale
京包线孤山站	locale
京包线堡子湾站	locale
南同蒲线洪善站	locale
京原线招柏站	locale
京原线云彩岭站	locale
京原线大涧站	locale
太岚线古交站	locale
太焦线长治站	locale
京包线聚乐堡站	locale
事故故障地点	locale
太兴线古交站3-7DG	locale
南同蒲线蒲州站、韩阳镇站、首阳站	locale
南同蒲线平遥站至	locale
侯阎线侯马站	locale
太原局北同蒲线忻口站	locale
太原局南同蒲线运城站	locale
太焦线郝村站至北田	locale
太兴线白文东站至白文北线路	locale
太原局南同蒲线赵城站	locale
太原局南同蒲线襄汾站至高	locale
太原局东港线东港站	locale
太原局南同蒲线张礼站至临汾站	locale
南同蒲线义棠站至洪善站间	locale
太原局管内侯月线沁水站至郑庄	locale
站间	locale
太原局石太线寿阳站	locale
大西高铁线太原南站	locale
东港线东港站	locale
云支线四台沟站	locale
忻州站至播明站间上行线、播明至忻州站间下行线	locale
大秦线蓟县西站	locale
介西线万安站至四公里	locale
北同蒲线原平站	locale
大秦线下庄至茶坞站间下行线	locale
太兴线静游站（含）至娄烦站间上行线	locale
宁岢线李家坪站	locale
大秦线柳村南站二场	depart
大秦线柳村南站一场	depart
北同浦线原平站	locale
大西客专线西安北大西场站	locale
大西线洪洞西站	locale
大中银线柳林南站	locale
大秦线下庄站至茶坞站	locale
大秦线茶坞至下庄站	locale
北同蒲线轩岗站焦家寨专用线	locale
大秦线稍营站至涿鹿站	locale
北同蒲线岱岳站至北周庄站	locale
大秦线卢龙北站	locale
太中银线文水站	locale
南同蒲线南关站至冷泉站间	locale
南同蒲线张礼站至临汾站间上行线	locale
太兴线岚县站	locale
太原南站石太场至长风街线路所间石太客专上行线K237+074处（平坡）	locale
宁岢线庄儿上站1-5DG轨道电路区段	depart
迁西站至迁安北站下行线K516+138	locale
瓦日线蒲县站至龙马站间下行	locale
石太线寿阳站至芹泉站间	locale
阳原站至化稍营站间下行线108+190	locale
灵石站至冷泉站间下行线515km+796m	locale
化稍营-逐鹿站间下行线158Km679m	locale
大秦线湖东二场至大同县站间下行线K35+35	locale
瓦日线石楼县站3道	locale
长风街线路所至太原站间大西上行线K272+572	locale
惠州西	locale
桐柏	locale
青龙	locale
格以头	locale
遂溪	locale
武胜	locale
石岘	locale
怀化	locale
大雁	locale
兰考	locale
高林屯	locale
靖宇	locale
沙海	locale
深河	locale
卫辉	locale
黄羊镇	locale
协荣	locale
李旺	locale
横沥	locale
蚌埠南	locale
辰清	locale
金家店	locale
木竹河	locale
小河镇	locale
威海	locale
塔哈	locale
永登	locale
东坝	locale
小河口	locale
商洛	locale
甘泉北	locale
焦作	locale
松韶关	locale
紫荆关	locale
查布嘎	locale
月华	locale
西固城	locale
万宁	locale
五五	locale
二塘区	locale
棋梓桥	locale
如东	locale
雁荡山	locale
沙岭庄	locale
金沙	locale
磨刀石	locale
高店铺	locale
海阳北	locale
通化县	locale
里木店	locale
武昌	locale
平遥古城	locale
达州	locale
暖泉	locale
上街	locale
广宁寺	locale
兴泉堡	locale
东明村	locale
下普雄	locale
简阳	locale
吉林	locale
玉溪	locale
青岛北	locale
北台子	locale
密山	locale
小新街	locale
金山北	locale
白浪	locale
昌乐	locale
永宁	locale
春阳	locale
前卫	locale
黑老湾	locale
青山堡	locale
岳家井	locale
窑村	locale
苏尼特左旗	locale
曲家店	locale
永寿	locale
永胜	locale
徐家	locale
沙岭子	locale
魏善庄	locale
新洲	locale
重庆东	locale
德阳	locale
盐津	locale
覃家坝	locale
南部	locale
邓州	locale
螺山	locale
前锋	locale
河市坝	locale
西小召	locale
雷州	locale
康城	locale
夏格庄	locale
阎良	locale
株洲	locale
新余	locale
老王洞	locale
耿坡	locale
甘棠	locale
中川机场	locale
斜河涧	locale
齐哈日格图	locale
下仓	locale
师宗	locale
草六格尔	locale
邵阳	locale
申家店	locale
歙县北	locale
溆浦南	locale
莱阳	locale
戚墅堰	locale
土门子	locale
小榆树	locale
伊通	locale
拉白	locale
左家	locale
南峪	locale
孝感北	locale
开封	locale
南票	locale
打兔寨	locale
贵阳	locale
彭泽	locale
商丘北	locale
长春	locale
洛西	locale
咸宁北	locale
石长	locale
南充	locale
甘谷	locale
低庄	locale
浦江	locale
南仓所	depart
浮梁	locale
悬钟	locale
桐梓	locale
广安南	locale
泰安	locale
东边井	locale
贲红	locale
*******	locale
砬子河	locale
萍乡北	locale
二龙	locale
宽沟	locale
罗山	locale
邢台	locale
三堂集	locale
小城	locale
延安	locale
新晃	locale
尼日	locale
冷水	locale
南京西	locale
长临河	locale
霞西	locale
白沙	locale
丰水村	locale
璧山	locale
武山	locale
松树	locale
大青沟	locale
朗乡	locale
建瓯	locale
黄陂	locale
耒阳西	locale
中宁东	locale
银浪	locale
扎鲁特	locale
福生庄	locale
经棚	locale
土牧尔台	locale
兰滩	locale
蒙渡	locale
长阳	locale
双辽	locale
醴陵东	locale
丰广	locale
湘府路	locale
新林	locale
陶思浩	locale
一四二公里	locale
新安	locale
肥东	locale
高潭子	locale
黄山北	locale
庙岭	locale
水城	locale
岭北	locale
成都南	locale
巴楚	locale
樟树	locale
大石寨	locale
永安乡	locale
哈福	locale
杜赵	locale
莱芜东	locale
永嘉	locale
屯沟湾	locale
塔山	locale
丁家营	locale
西峡	locale
哈尔滨	locale
大东	locale
丹阳	locale
朱亭	locale
双水	locale
山市	locale
凯北	locale
晏家坝	locale
维罗	locale
莆田	locale
兰岗	locale
遵义西	locale
海满	locale
青水山	locale
天龙	locale
狼窝铺	locale
凤凰城	locale
汤河	locale
漯河	locale
连云港东	locale
卓资山	locale
营盘湾	locale
公主岭南	locale
红卫坝	locale
班猫箐	locale
锦州南	locale
涞源	locale
河唇	locale
融水	locale
流溪场	depart
蓝家村	locale
基长	locale
小寺沟	locale
紫阳	locale
冯家山	locale
弥勒	locale
三门峡南	locale
娄山	locale
*	locale
大坑口	locale
连山关	locale
关林	locale
疏勒	locale
福隆	locale
安庆西	locale
五十家子	locale
营城	locale
牛心台	locale
虎门	locale
九三	locale
酉阳	locale
五棵树	locale
吴家庄	locale
禹城	locale
南翔北	locale
古源	locale
临河	locale
石庙沟	locale
尚家	locale
石桥子	locale
涟源	locale
乌奴耳	locale
宜春西	locale
海拉尔东	locale
汇流河	locale
曲阜	locale
瑞昌西	locale
民福寺	locale
叶榭	locale
龙里	locale
西江	locale
黄草场	depart
代马沟	locale
莒县	locale
山坡东	locale
煤山	locale
下板城	locale
午汲	locale
兴业	locale
麻旺	locale
延吉	locale
宋	locale
杭州	locale
福田	locale
济南	locale
建昌	locale
建瓯西	locale
兴隆镇	locale
向阳镇	locale
东台	locale
白村	locale
集宁	locale
昆明	locale
襄樊北	locale
陈相屯	locale
界山	locale
武穴	locale
临水	locale
李子沟	locale
枕头峰	locale
勃利	locale
绥德	locale
新都东	locale
太要	locale
田庄	locale
灵仙庙	locale
花家庄	locale
进贤南	locale
发耳	locale
长春西	locale
天府北	locale
德安	locale
梅家庄	locale
岔河	locale
北井子	locale
荆门	locale
烟台	locale
宇宙地	locale
汉沽	locale
禄丰南	locale
宁东南	locale
丽江	locale
文地	locale
大山铺	locale
西平	locale
麻栗树	locale
许昌	locale
朝阳镇	locale
劲涛	locale
陈官营	locale
牛庄	locale
安广	locale
长沙	locale
韶关	locale
巨各庄	locale
海口东	locale
分宜	locale
走马岭	locale
南宁西	locale
珞璜	locale
北召店	locale
山口	locale
石龙	locale
李石寨	locale
汪清	locale
乐埠	locale
丰润	locale
丰顺	locale
石林南	locale
巢湖东	locale
渭南北	locale
碱柜	locale
临潼	locale
明港	locale
乌龙泉南	locale
红砂坝	locale
大堡	locale
桦林	locale
庆华	locale
林东	locale
升昌	locale
署字井	locale
慈利	locale
安阳东	locale
呼源	locale
拉萨	locale
休宁	locale
塔前	locale
灵璧	locale
城阳	locale
凤阳	locale
石湖村	locale
万年	locale
福德	locale
高邑	locale
西安东	locale
湘潭	locale
大湾子	locale
新会	locale
綦江北	locale
皇路店	locale
京寨	locale
南沟	locale
大滩	locale
红寺堡	locale
清华园	locale
邳州	locale
叶茂	locale
柘车河所	depart
防城港北	locale
诏安	locale
白彦花	locale
金华西	locale
萨拉齐	locale
安靖	locale
乾安	locale
福安	locale
寿昌	locale
贵阳西	locale
许三湾	locale
南宁	locale
三门峡	locale
汉源	locale
来宾北	locale
利川	locale
兴国	locale
花园	locale
抚远	locale
白河东	locale
武店	locale
石板哨	locale
华容	locale
葛根庙	locale
丽江东	locale
哈尔滨北	locale
红房子	locale
武清	locale
固始	locale
东龙	locale
天桥	locale
深圳北	locale
乌海北	locale
公兴	locale
滑县南	locale
柳树屯	locale
龙洞堡	locale
南仓	locale
赤壁北	locale
塘渡口	locale
下花园	locale
亭林	locale
梨树湾	locale
三明北	locale
锦界	locale
灯塔	locale
崇左	locale
正定机场	locale
彰武	locale
瓦拉干	locale
醴陵	locale
滩头湾	locale
新窝铺	locale
北票南	locale
株洲西	locale
隆昌北	locale
兰考南	locale
新绰源	locale
乐都南	locale
路口铺	locale
寒葱沟	locale
平顶庙	locale
银滩	locale
甸心	locale
察尔汗	locale
神木北	locale
库车	locale
黑台	locale
茶条沟	locale
府谷	locale
沁河北	locale
长安镇	locale
兴和西	locale
西大庙	locale
沙村	locale
新津南	locale
普洱渡	locale
广州东	locale
永丰营	locale
蕲春	locale
济源	locale
石门	locale
英吉沙	locale
兰陵北	locale
湖潮	locale
五府山	locale
永福	locale
江津	locale
上西铺	locale
石场	locale
大湾	locale
临平	locale
玉溪西	locale
独李村	locale
平庄南	locale
蔡家沟	locale
扎音河	locale
哈尔滨西	locale
烟筒山	locale
西大滩	locale
盘龙城	locale
三合场	locale
阿勒泰	locale
喀拉玉尔滚	locale
杭州南	locale
大足南	locale
十三间房	locale
富县东	locale
大石板	locale
扶绥	locale
白云鄂博	locale
权河	locale
新坪田	locale
蒙自北	locale
廊坊北	locale
连江口	locale
芨岭	locale
源迁	locale
挖色	locale
绿博园	locale
广州北	locale
清原	locale
德日斯图	locale
新华屯	locale
横店	locale
建水	locale
严关乡	locale
镇罗堡	locale
健民	locale
阿图什	locale
猴山	locale
德保	locale
两当	locale
风水沟	locale
黄柏	locale
湖头	locale
西昌北	locale
加南	locale
南城司	locale
川弓	locale
纸坊东	locale
白田坝	locale
大河坝	locale
吐鲁番北	locale
宁波	locale
桥西	locale
黄羊滩	locale
新乡东	locale
大埔	locale
红彦	locale
万乐	locale
昂昂溪	locale
临海	locale
二郎庙	locale
双桥	locale
天堂	locale
南充北	locale
新干	locale
滴道	locale
郑州西	locale
电白	locale
道州	locale
息烽	locale
朝阳川	locale
防城港	locale
敦化	locale
大磴沟	locale
襄樊东	locale
华容南	locale
大战场	locale
茂名	locale
甲堡	locale
泗水	locale
倮果	locale
落垡	locale
桂林	locale
黄桶	locale
库都尔	locale
刘伟壕	locale
诸暨	locale
宁家	locale
金场堡	locale
宜宾南	locale
加格达奇	locale
丹东	locale
牛街	locale
彭山北	locale
一面山	locale
黄河景区	locale
卧龙寺	locale
碧水	locale
平凉	locale
小姑家	locale
明白村	locale
乌兰察布	locale
天岗	locale
翁通	locale
洋县	locale
南京南	locale
沙坡头	locale
海龙	locale
果河	locale
高碑店	locale
三都县	locale
普安县	locale
贵定南	locale
青莲	locale
同心	locale
乐山北	locale
云梦	locale
南尔岗	locale
沙日乃	locale
榆树沟	locale
角美	locale
武隆	locale
忙罕屯	locale
武陟	locale
麦园	locale
二道沙河	locale
虎林	locale
黄龙	locale
定边	locale
平关	locale
土坎	locale
南平	locale
铁佛寺	locale
东营	locale
铜陵北	locale
郴州	locale
松江	locale
朱家窑	locale
十堰	locale
郭家屯	locale
马坝	locale
邵武	locale
嘎拉德斯汰	locale
金沙湾	locale
感德	locale
红花沟	locale
中山	locale
免渡河	locale
下城子	locale
格里坪	locale
小儿坪	locale
侯马西	locale
达州东	locale
姚渡	locale
普舍寨	locale
热水	locale
苟各庄	locale
鱼儿沟	locale
彭水	locale
辽源	locale
赵光	locale
娄底	locale
槐安	locale
皂角铺	locale
曲水县	locale
大西	locale
了墩	locale
神峪河	locale
黑旺	locale
团结	locale
新铁村	locale
邵东	locale
九里	locale
钟山西	locale
密云北	locale
瓦房	locale
塘沽	locale
费县	locale
闻庄	locale
回龙坝	locale
库伦	locale
大民屯	locale
十八台	locale
北仓	locale
吐列毛杜	locale
高台南	locale
临高南	locale
燕郊	locale
肥西	locale
南昌北	locale
张维屯	locale
红砂岘	locale
平洋	locale
姚安	locale
朝中	locale
固城	locale
深井子	locale
兴隆店	locale
东方红	locale
峻德	locale
泉州东	locale
咸宁南	locale
闵集	locale
辛集	locale
九龙	locale
凤翔	locale
深圳东	locale
大郑	locale
宝丰	locale
磐安镇	locale
贺家店	locale
小月旧	locale
乐山	locale
裴德	locale
什里店	locale
毕克齐	locale
眉山	locale
乐清	locale
临澧	locale
红石崖	locale
沈家河	locale
绥中北	locale
大荔北	locale
松坝	locale
松桃	locale
唐官屯	locale
雁儿崖	locale
兴安	locale
渑池南	locale
宜宾	locale
张台子	locale
龙头	locale
田东	locale
福海	locale
老城镇	locale
梁山	locale
陶家屯	locale
绥棱	locale
唐河	locale
湛江	locale
新县	locale
繁昌北	locale
苏北	locale
九台南	locale
张家界	locale
绿化	locale
欧里	locale
布海	locale
千岛湖	locale
东通化	locale
德州	locale
韦庄	locale
高梁铺	locale
碾子山	locale
亮甲店	locale
石门坎	locale
水洞	locale
龙门河	locale
坝梁	locale
万发屯	locale
海浪	locale
查干哈达	locale
马海	locale
小箐	locale
安居	locale
宾阳	locale
南河	locale
青山	locale
潼关	locale
长发屯	locale
沙子河	locale
南头	locale
核桃园	locale
虎尔虎拉	locale
樟林	locale
尚武	locale
牟平	locale
鹿道	locale
许昌东	locale
庆安	locale
大兴镇	locale
老莱	locale
苍南	locale
滦河	locale
淮南东	locale
秦家	locale
本溪新城	locale
平安驿	locale
张寨	locale
南丹	locale
杨林	locale
洛碛	locale
米易	locale
繁昌西	locale
仓山镇	locale
岐山	locale
南丰	locale
金珠	locale
莫干山	locale
吉安南	locale
石头	locale
长河碥	locale
朱石寨	locale
平原	locale
老羊壕	locale
岔滩	locale
庙子沟	locale
彭阳	locale
临泽南	locale
弯	locale
温根托海	locale
包官营	locale
图们北	locale
干沟	locale
骆驼巷	locale
红兴隆	locale
西昌	locale
松江河	locale
高老	locale
兰州新区	locale
小金口	locale
青溪	locale
昆都庙	locale
泰州	locale
高安	locale
源潭	locale
临城	locale
西湖东	locale
杨家岭	locale
汇塘河	locale
羊堡	locale
土溪	locale
海安南	locale
黄	locale
磨溪	locale
前榆	locale
江华	locale
哈尔滨东	locale
威宁	locale
南华北	locale
夏集	locale
白合	locale
富锦	locale
姜家	locale
饶阳	locale
汝州	locale
石柱县	locale
塘豹	locale
盘关	locale
祁阳	locale
羊尾哨	locale
富川	locale
太阳村	locale
马架子	locale
大庆东	locale
双河口	locale
苏家屯	locale
根河	locale
沙河市	locale
威岭	locale
红安西	locale
延津	locale
松河	locale
索伦	locale
仙水	locale
普雄	locale
官字井	locale
大武口	locale
元山子	locale
玉泉	locale
李市镇	locale
治山	locale
温都和硕	locale
古镇	locale
冠豸山	locale
三水南	locale
和村	locale
新沂	locale
民族	locale
高兴	locale
麻山	locale
会同	locale
天义	locale
刀尔登	locale
分水寺	locale
彬江	locale
永城北	locale
凉风垭	locale
熊岳城	locale
峨边	locale
高家村	locale
长寿	locale
平邑	locale
巢湖	locale
横江	locale
马头	locale
彝良南	locale
大田边	locale
昆独仑召	locale
罗盘地	locale
双城北	locale
春亭阁	locale
乔子玄	locale
亳州	locale
江桥	locale
大洋洲	locale
六安	locale
蔺市	locale
古城	locale
六合镇	locale
白石山	locale
兰州东	locale
大雅河	locale
邵阳北	locale
大余	locale
查干芒和	locale
沙力	locale
双牌	locale
兴福	locale
包头东	locale
始兴	locale
东海	locale
晏城	locale
义乌	locale
阳邑	locale
南宁东	locale
老边	locale
横店东	locale
胪滨	locale
亚沟	locale
巴彦郭勒	locale
大江口	locale
乐东	locale
厦门高崎	locale
南杂木	locale
偏岭	locale
乌尔旗汗	locale
偃师	locale
简阳南	locale
白银哈尔	locale
贾鲁河	locale
大庆西	locale
西丽	locale
全椒	locale
小得江	locale
新民	locale
金马村	locale
于都	locale
霍邱	locale
群力	locale
广顺场	locale
松江镇	locale
达家沟	locale
土贵乌拉	locale
天柱山	locale
吉水	locale
南江	locale
西乡	locale
白涧	locale
平等	locale
镇安	locale
廉江	locale
滕州	locale
栟茶	locale
高各庄	locale
攸县南	locale
马蹄湾	locale
魏杖子	locale
白水江	locale
营口东	locale
隆安东	locale
海宁	locale
渭源	locale
好鲁库	locale
沈阳西	locale
四分滩	locale
涉县	locale
龙丰	locale
十字铺	locale
农安	locale
官家	locale
肃宁	locale
天水南	locale
白河县	locale
沂南	locale
石滩	locale
灵宝西	locale
亭亮	locale
贵阳东	locale
通安驿	locale
六道河	locale
海城西	locale
金华南	locale
梨树镇	locale
古固寨	locale
莎车	locale
甘家坝	locale
金坑	locale
高桥镇	locale
燕家庄	locale
平湖	locale
盘锦北	locale
库尔勒	locale
三道营	locale
大土	locale
沈家	locale
劳动屯	locale
团结村	locale
大足	locale
福港	locale
张百湾	locale
泾川	locale
利津南	locale
商河	locale
广通北	locale
中兴	locale
天桥岭	locale
明光	locale
大陵	locale
北京	locale
岭南	locale
小西庄	locale
宣城	locale
兴隆县	locale
松滋	locale
尤溪	locale
婺源	locale
西小沟	locale
大英东	locale
海城	locale
三道湖	locale
上虞北	locale
吴家屯	locale
阿巴嘎旗	locale
迎水桥	locale
西枣林	locale
三水	locale
青龙场	locale
金谷	locale
那铺	locale
杨树岭	locale
新城子	locale
乌兰胡同	locale
豪门	locale
齐齐哈尔南	locale
天津西	locale
周家	locale
溶口	locale
德州东	locale
小北	locale
汤山城	locale
刘家河	locale
茂名西	locale
柞水	locale
兴平	locale
佟家	locale
下夹河所	depart
凤县	locale
倒湖	locale
桃映	locale
溧阳	locale
串子沟	locale
闽清北	locale
巴关岭	locale
白泉	locale
荆州	locale
敖来	locale
新都	locale
孔家沟	locale
桃儿湾	locale
长沙埂	locale
祁东	locale
南山北	locale
商丘	locale
伊尔施	locale
**********	locale
乌拉特前旗	locale
苍石	locale
二道湾	locale
开原西	locale
向阳川	locale
哈达铺	locale
他石海	locale
恩施	locale
昆明东	locale
狼尾山	locale
泰达	locale
湾沚	locale
三元坝	locale
达板城	locale
笔架山	locale
伊和恩格拉	locale
党家庄	locale
乌海西	locale
石门县南	locale
富源	locale
嫩江	locale
二道岩	locale
章党	locale
宝林	locale
凉红	locale
毛陈	locale
精河	locale
石湖	locale
墩义堂	locale
芦潮港	locale
革居	locale
濮阳	locale
瀼河	locale
干塘	locale
吴场	locale
武夷山北	locale
重庆南	locale
东丰	locale
二道桥	locale
昂乃	locale
湖州	locale
莱西北	locale
四马架	locale
湖州南	locale
都匀东	locale
高坪铺	locale
贺胜桥东	locale
茨坝	locale
草市	locale
大庙	locale
滦河沿	locale
皮口	locale
板城	locale
武昌东	locale
大苴	locale
野马寨	locale
横沟桥东	locale
成都	locale
铜鼓井	locale
盐池	locale
裕民	locale
许家台	locale
天水	locale
桐乡	locale
磁窑	locale
红果	locale
平泉	locale
兰州	locale
换新天	locale
达日其嘎	locale
镇平	locale
舒兰	locale
鸡西	locale
鄂尔多斯	locale
红土沟	locale
宣和	locale
刘家店	locale
铁厂	locale
新友谊	locale
渠县	locale
塔石嘴	locale
武当山	locale
官高	locale
左岭	locale
阎家	locale
铅山西	locale
安亭北	locale
王瞳	locale
前磨头	locale
鸦雀岭	locale
西哲里木	locale
鄯善北	locale
南河川	locale
九郎山	locale
大坝	locale
五道沟	locale
红光镇	locale
美溪	locale
青岛	locale
祁阳北	locale
月池台	locale
禄市	locale
索图罕	locale
观阁	locale
白旗	locale
抚顺	locale
四合	locale
宁强	locale
长安	locale
龙泉寺	locale
大溶江	locale
麻柳镇	locale
鹤立	locale
碾庄	locale
中宁	locale
昭通北	locale
鹤岗	locale
中嘴	locale
焦作东	locale
莲东	locale
陶辛	locale
浠水	locale
北磴	locale
郑家堡	locale
炎陵	locale
五莲	locale
宁明	locale
思	locale
垭口	locale
道劳杜	locale
诸城	locale
大杨树东	locale
六道河子	locale
二龙山屯	locale
黄康	locale
郭家店	locale
贺州	locale
西哈	locale
郫县	locale
新郑机场	locale
贵定	locale
白沙坡	locale
王家营	locale
白银市	locale
扎兰屯	locale
内乡	locale
清远	locale
龙镇	locale
临淄	locale
颍上	locale
秧草地	locale
开通	locale
怀柔北	locale
黄联关	locale
曹家营子	locale
干溪沟	locale
永康南	locale
全州	locale
温泉寺	locale
枫林	locale
湛江西	locale
峡江	locale
江源	locale
兴安北	locale
碧州	locale
陶家沟	locale
赛金桥	locale
广州西	locale
石沱	locale
武义	locale
东莞东	locale
拉哈	locale
宁德	locale
七泉湖	locale
福山镇	locale
养马河	locale
军垦	locale
宋城路	locale
玉石	locale
玉舍	locale
忽吉图	locale
黄冈东	locale
荣成	locale
青花	locale
白沙沱	locale
五凤溪	locale
永郎	locale
八虎力	locale
塔尔气	locale
王安镇	locale
上万	locale
枣子林	locale
那罗	locale
华城	locale
上饶	locale
大米溪	locale
瓦窑坝	locale
程村	locale
李河	locale
**	locale
哈拉沟	locale
新松浦	locale
鼎湖东	locale
榆树台	locale
郓城	locale
营城子	locale
猛鹫山	locale
黄平	locale
三平	locale
苏坂	locale
茂林	locale
文阁	locale
临泽	locale
嘉祥	locale
吴桥	locale
余姚北	locale
孤山子	locale
大厂县	locale
石人	locale
东津	locale
磁西	locale
昌吉	locale
阿拉山口	locale
安图	locale
白城	locale
喜德	locale
米沙子	locale
呼家塔	locale
白音他拉	locale
向塘	locale
大沙田	locale
丹东西	locale
长兴	locale
胶州	locale
飞来峡	locale
泔溪	locale
大德	locale
白狼	locale
溪洞	locale
嵩明	locale
内邱	locale
顺德	locale
倭肯	locale
大林	locale
徐屯	locale
尼木	locale
大罕	locale
大灰厂	locale
石门村	locale
轵城	locale
夏官营	locale
郁山	locale
阳春	locale
闽清	locale
杨陵南	locale
沙塘	locale
乐武	locale
四平东	locale
包头	locale
遵义	locale
旬阳	locale
当雄	locale
盖州	locale
巴关河	locale
夏家河	locale
首山	locale
东宫	locale
佛山	locale
哈密	locale
富海	locale
茄子溪	locale
犀浦东	locale
洛东	locale
滩	locale
老锅厂	locale
曲靖	locale
江市	locale
汉王山	locale
泉州	locale
腊哈地	locale
励家	locale
岳阳	locale
红花园	locale
东水峡	locale
日喀则	locale
革志	locale
月山	locale
拉古	locale
胜芳	locale
淮安南	locale
屏边	locale
南洼	locale
泽润里	locale
五大连池	locale
平峪	locale
大官屯	locale
浪河	locale
北岗	locale
巴日图	locale
五龙背	locale
五龙背东	locale
前窑	locale
天祝	locale
集宁南	locale
叉车厂	locale
汤阴	locale
林西	locale
宁乡	locale
梨子山	locale
独山	locale
太阳山	locale
田心东	locale
坦甸	locale
哈日努拉	locale
肇东	locale
泰山	locale
南塘镇	locale
韩府湾	locale
洛阳龙门	locale
昆山南	locale
满归	locale
庙宫	locale
带岭	locale
八义集	locale
高峰	locale
双流机场	locale
龙潭寺	locale
梁平南	locale
东门	locale
树舍	locale
孟庄	locale
塔尔根	locale
包庄	locale
金刚沱	locale
哲里木	locale
明珠	locale
星朗	locale
东安东	locale
柴沟堡	locale
石岭	locale
安家	locale
梧州南	locale
柳州	locale
大石桥	locale
吴家川	locale
关村坝	locale
哈尔盖	locale
龙爪沟	locale
海林	locale
北海	locale
长武	locale
尚志	locale
包头西	locale
界首市	locale
永修	locale
邓家湾	locale
合阳北	locale
礼泉	locale
公积坂	locale
百里村	locale
夏石	locale
荣昌北	locale
黎塘	locale
双吉	locale
嘉川	locale
黄瓜园	locale
天河机场	locale
临邑	locale
晋江	locale
归德乡	locale
白涛	locale
高楼房	locale
擦耳	locale
乐都	locale
攸县	locale
树林	locale
宏图	locale
陶赖昭	locale
绥阳	locale
宝龙山	locale
共青城	locale
葛店南	locale
爱河	locale
白塔	locale
营山	locale
铜佛寺	locale
刚察	locale
芙蓉南	locale
洪河	locale
潮阳	locale
奎屯	locale
柳树	locale
亮兵台	locale
松树镇	locale
兴无	locale
徘徊北	locale
红峰	locale
四方	locale
天西	locale
临溪	locale
绕阳河	locale
绥芬河	locale
沃皮	locale
青岭子	locale
延吉西	locale
大塔	locale
锦河	locale
治安	locale
上腰墩	locale
获鹿所	depart
皇德	locale
柳毛	locale
旺苍	locale
嘉善南	locale
姜堰	locale
钟山	locale
青杠	locale
临江场	locale
紫沟	locale
罗平	locale
白马	locale
迎宾路	locale
化处	locale
章丘	locale
长兴南	locale
朱嘎	locale
长冲	locale
小浩	locale
广州	locale
庙庄	locale
泡子	locale
哈拉苏	locale
麻尾	locale
煤田	locale
新平坝	locale
通远堡	locale
合肥西	locale
南大庙	locale
松青	locale
昌平北	locale
秀山	locale
白鸡坡	locale
嘎什甸子	locale
华山	locale
西昌南	locale
杨柳街	locale
重庆西	locale
石家砭	locale
甲山	locale
东港北	locale
旬阳北	locale
崇信	locale
温泉	locale
青堆	locale
横道河子	locale
黑井	locale
钟祥	locale
无锡新区	locale
祁家堡	locale
麻芝铺	locale
襄阳东	locale
马嘎	locale
四平	locale
鸡公山	locale
白银西	locale
赶水	locale
普家村所	depart
五叉沟	locale
白芨沟	locale
范家屯	locale
开安	locale
老府	locale
吕城	locale
上河清	locale
渔坝村	locale
下坑子	locale
富县	locale
磐石	locale
扎泥河	locale
石林	locale
武夷山	locale
龙门南	locale
余江	locale
长胜沟	locale
缯溪河	locale
巩义	locale
春申	locale
卧牛河	locale
北马圈子	locale
炮车	locale
长汀南	locale
大坪	locale
青白江东	locale
大昌	locale
玛纳斯湖	locale
哈克	locale
垫江	locale
兴城	locale
高滩	locale
三义井	locale
通辽北	locale
查干特格	locale
金州	locale
沙桥	locale
红星	locale
饮马峡	locale
古里金	locale
陇西	locale
东明县	locale
宁国	locale
田林	locale
汐子	locale
三营	locale
沈阳	locale
宝坻	locale
淇县	locale
临颍	locale
红江	locale
姚家	locale
双福	locale
六盘水	locale
乌固诺尔	locale
高台子	locale
渭南南	locale
凌海	locale
金银潭	locale
鸽子洞	locale
泉沟	locale
黄家营	locale
通海	locale
通化	locale
福鼎	locale
邢台东	locale
石马坝	locale
三汇镇	locale
沈阳南	locale
西安	locale
丰城	locale
龙伯屯	locale
惠农	locale
叶柏寿	locale
嘉峪关南	locale
莲花山	locale
花湖	locale
英德西	locale
抚松	locale
赣州	locale
丰台西	locale
山河屯	locale
峨眉	locale
麻柳	locale
铁力	locale
凤城东	locale
大深	locale
港口镇	locale
廊坊	locale
亚龙湾	locale
猛洞河	locale
南湖东	locale
黄甲屯	locale
沧州	locale
小南垭	locale
咸阳秦都	locale
德伯斯	locale
商丘南	locale
酒泉南	locale
巴东	locale
樟木头东	locale
宜城	locale
一平浪	locale
大理北	locale
长垣	locale
冕山	locale
新开	locale
祁东北	locale
杨木	locale
青铜峡	locale
义县	locale
大用	locale
银镇	locale
弋阳	locale
元田坝	locale
纪家沟	locale
田独	locale
嘉兴南	locale
构林	locale
广元东	locale
绥西	locale
上寺	locale
双石桥	locale
大冶北	locale
罗江东	locale
帽儿山	locale
亚河	locale
涿州	locale
宝泉岭	locale
保家楼	locale
开封北	locale
元坝	locale
蓬安	locale
砀山南	locale
新化	locale
上板城	locale
龙井村	locale
安平	locale
楚雄南	locale
南汤	locale
石景山南	locale
徐州东	locale
马角坝	locale
涧池铺	locale
草海	locale
龙家营	locale
阜阳	locale
中牟	locale
南华	locale
九台	locale
仙林	locale
石嘴山	locale
宜良北	locale
建北	locale
甲路	locale
向阳	locale
天回镇	locale
庐山	locale
东富	locale
松树台	locale
望江	locale
鸡冠山	locale
瓢儿屯	locale
黄丝	locale
柳树泉	locale
砀山	locale
扬州	locale
南岔	locale
先锋	locale
董庄	locale
苏州新区	locale
古城子	locale
顺义	locale
兴莲	locale
苏集	locale
南平北	locale
杭州东	locale
洪家嘴	locale
露水河	locale
鲅鱼圈	locale
舍力虎	locale
东二道河	locale
长岭子	locale
镇赉	locale
博白	locale
甘旗卡	locale
奔牛	locale
照福铺	locale
长虹	locale
新坡	locale
卧里屯	locale
金宝屯	locale
和平	locale
万州北	locale
乌鲁木齐	locale
西沟	locale
武功	locale
西八里	locale
金城江	locale
临沂	locale
江边村	locale
娄底南	locale
阿乌尼	locale
沾益	locale
句容西	locale
延庆	locale
坞坭	locale
琥市	locale
贵定县	locale
中和	locale
惠环	locale
小村	locale
绵阳	locale
宏庆	locale
崖州	locale
海北	locale
江宁西	locale
官渡	locale
宝华山	locale
平果	locale
学庄	locale
二营子	locale
福泉	locale
双流	locale
通天屯	locale
普者黑	locale
岳池	locale
樟木头	locale
棠海	locale
昌平	locale
马林	locale
蒲坝	locale
改貌	locale
茶淀	locale
通远堡西	locale
双流西	locale
天门南	locale
紫溪	locale
城固	locale
九燕山	locale
谢家	locale
塔石咀	locale
喀什	locale
卡路屯	locale
燕子砭	locale
小东	locale
咸阳	locale
洛阳	locale
三穗	locale
横现河	locale
英额门	locale
塘雅	locale
进贤	locale
漯河西	locale
临汾西	locale
劲松	locale
王场	locale
四分地	locale
蛟河西	locale
德惠	locale
红柳河	locale
继承	locale
雁翅	locale
新青	locale
辉河	locale
白沟	locale
广元	locale
黄集	locale
师庄	locale
凌源	locale
任丘	locale
枝江	locale
南博山	locale
小雨谷	locale
上仓	locale
肇庆	locale
木镇	locale
大松树	locale
庄河北	locale
厦门北	locale
李家坪	locale
兴隆山	locale
沥林北	locale
沂水	locale
营盘上	locale
谭庄	locale
柳毛沟	locale
海安县	locale
黄家店	locale
卫星	locale
咸宁	locale
新李	locale
枝城	locale
弯集	locale
郭尔奔敖包	locale
南城	locale
水花	locale
芦家村	locale
七龙星	locale
平南南	locale
罗妙真	locale
望溪	locale
威箐	locale
涪陵	locale
深圳西	locale
长寿湖	locale
红岘台	locale
重庆北	locale
台安	locale
读书铺	locale
鹤壁东	locale
盖州西	locale
高家	locale
南关岭	locale
长城	locale
桂林西	locale
丹阳北	locale
吴圩	locale
文畈	locale
虢镇	locale
邢家堡	locale
宜州	locale
双龙	locale
大杨树	locale
广州南	locale
靖州	locale
沾河	locale
赣州东	locale
阿贵图	locale
曲阜东	locale
立志	locale
南京	locale
孙家	locale
马鞍岭	locale
汉阴	locale
德惠西	locale
孔垄	locale
铜仁	locale
鲁番	locale
南湾子	locale
街基	locale
开原	locale
花果	locale
抚州北	locale
辽阳	locale
大保当	locale
河口北	locale
尼勒克	locale
三井子	locale
杨各庄	locale
符离集	locale
石脑	locale
靖远西	locale
洛社	locale
红旗营	locale
大杖子	locale
西宁西	locale
犀浦	locale
吕河	locale
蓟县南	locale
北滘	locale
七苏木	locale
南曹	locale
孝感	locale
邯郸	locale
高兴镇	locale
庙阳	locale
蒲山店	locale
上海西	locale
思甜	locale
鹤北	locale
新寒岭	locale
琅琊	locale
岔江	locale
新高峰	locale
北京东	locale
岩山	locale
六盘山	locale
大丰	locale
榕江	locale
江口集	locale
王家坝	locale
洛门	locale
四道湾	locale
玉门镇	locale
讷河	locale
明水河	locale
开江	locale
古家沱	locale
三江口	locale
南昌	locale
惠州	locale
安庆	locale
庆丰	locale
鞍山西	locale
涪陵北	locale
葵潭	locale
桓台	locale
双峰北	locale
巨野	locale
弄弄坪	locale
锦和	locale
正定	locale
康熙岭	locale
马村	locale
双望	locale
饶平	locale
靖边	locale
丰台	locale
巨亭	locale
都江堰	locale
仙桃西	locale
乌鲁木齐南	locale
丽水	locale
秦岭	locale
榆树川	locale
凯里西	locale
沙坝	locale
芝罘	locale
二道河	locale
奈曼	locale
大屯	locale
克东	locale
马铺营	locale
凉水井	locale
苍坪	locale
山城镇	locale
湾边	locale
昆都仑召	locale
刘家村	locale
彝良	locale
山海关	locale
拉林	locale
枣庄西	locale
茶陵南	locale
刘集	locale
巢北	locale
太白	locale
黑冲滩	locale
张家川	locale
江宁	locale
氡泉	locale
新窑	locale
夏拉哈马	locale
任家店	locale
昆明南	locale
虎什哈	locale
德令哈	locale
阜南	locale
六甲	locale
西安北	locale
马龙	locale
上普雄	locale
沙县	locale
龙市	locale
龙亭	locale
复盛	locale
册亨	locale
泗阳	locale
漳浦	locale
铜鼓溪	locale
潍坊	locale
常平	locale
平山	locale
沙坨子	locale
新桥	locale
永福南	locale
杨家营	locale
固安	locale
景德镇	locale
勤丰营	locale
金寨	locale
瓜州	locale
乐昌东	locale
赤壁	locale
小黑山	locale
杨村	locale
庄河	locale
牛栏山	locale
茂舍祖	locale
小河沿	locale
乌伊岭	locale
图里河	locale
济南西	locale
三道桥	locale
大河桥	locale
黄水塘	locale
拉法	locale
沙沱	locale
狮山	locale
辽中	locale
水曲柳	locale
伊林	locale
綦江	locale
梅江	locale
白河	locale
半边街	locale
平房	locale
九营	locale
托托	locale
孔滩	locale
六里坪	locale
驼腰岭	locale
营街	locale
东京城	locale
略阳	locale
史家铺	locale
三亚	locale
代湾	locale
姑家堡	locale
张家界北	locale
共和	locale
槐荫	locale
黄泥崴子	locale
灵宝	locale
乐平市	locale
沙后所	depart
郭家营	locale
镇远	locale
铜陵	locale
民和	locale
小哨	locale
湟源	locale
明阳	locale
********	locale
白石岩	locale
丹凤	locale
平罗	locale
卫东	locale
汨罗东	locale
水地	locale
东升坝	locale
桦皮厂	locale
苏家坡	locale
沙琅	locale
滦县东	locale
兰州西	locale
石门县	locale
唐山北	locale
北安	locale
石门子	locale
封丘	locale
那玉	locale
珠斯花	locale
福利屯	locale
宜昌	locale
青县	locale
杨陵	locale
三十里铺	locale
蒲城	locale
阳朔	locale
来福	locale
渑池	locale
陆川	locale
虎石台	locale
南口	locale
土地堂东	locale
柏果	locale
巡场	locale
裕国	locale
巴林	locale
洛湾三江	locale
黄冈	locale
芜湖	locale
福山口	locale
灌水	locale
金月湾	locale
枫泾	locale
疏勒河	locale
牛头山	locale
峰高铺	locale
一步滩	locale
到保	locale
洞井	locale
长山屯	locale
秋木庄	locale
浩良河	locale
崇仁	locale
高炉子	locale
大竹园	locale
卓资东	locale
乌斯土	locale
杨家店	locale
临江	locale
三花石	locale
苏州	locale
潮汕	locale
普宁	locale
新华庄	locale
成吉思汗	locale
周水子	locale
上海南	locale
萧县北	locale
南芬	locale
张家堡	locale
小榄	locale
黄州	locale
文登	locale
昭化	locale
当涂东	locale
桐子林	locale
北林	locale
东南营子	locale
葡萄菁	locale
九里山	locale
新香坊	locale
泉江	locale
石人城	locale
野三坡	locale
杨家	locale
应城	locale
东营南	locale
天津	locale
安陆	locale
甘泉	locale
江西村	locale
花山	locale
龙南	locale
缙云	locale
陈家湖	locale
镜铁山	locale
华安	locale
密马龙	locale
上板城南	locale
施秉	locale
雅河	locale
青白江	locale
岳阳北	locale
王团庄	locale
葫芦岛	locale
德胜	locale
乔村	locale
岑溪	locale
曹子里	locale
嵯岗	locale
徐闻	locale
鹤庆	locale
大营镇	locale
东莞	locale
互助	locale
酒泉	locale
六合	locale
双城堡	locale
黔城	locale
榆中	locale
门源	locale
吴官田	locale
八方	locale
黄石	locale
迎祥街	locale
铜罐驿	locale
井陉	locale
榆树屯	locale
金鸡村	locale
转关口	locale
建安	locale
霞浦	locale
云山	locale
羊场	locale
蓝村	locale
小山	locale
官厅西	locale
山丹	locale
建阳	locale
珠窝	locale
惠州南	locale
凤州	locale
军山	locale
迎春	locale
顺河场	locale
苦李井	locale
咸宁东	locale
西岗子	locale
黄村	locale
太姥山	locale
陶卜齐	locale
潭岗	locale
玉林	locale
上关	locale
土们岭	locale
武威	locale
豆庄	locale
苏州北	locale
容桂	locale
即墨北	locale
小溪坝	locale
泾县	locale
阳岔	locale
阿里河	locale
乐素河	locale
五营	locale
夏邑县	locale
辛庄子	locale
乌海	locale
襄阳	locale
六枝	locale
青羊湾	locale
柳园南	locale
滨江	locale
宁陵县	locale
八仙筒	locale
临沂北	locale
黄梅	locale
苏州园区	locale
威海北	locale
华家	locale
泸阳	locale
广南卫	locale
火烧寨	locale
临江溪	locale
壮志	locale
盘古寺	locale
新场	locale
镇紫街	locale
博克图	locale
南口前	locale
钦州东	locale
四家子	locale
大巴	locale
兴宁	locale
定西	locale
马柳	locale
百里峡	locale
石山	locale
凯里	locale
都伦	locale
水家湖	locale
桐城	locale
羊草	locale
赛汗塔拉	locale
梁家渡	locale
鲁河	locale
晨明	locale
敦煌	locale
泗洪	locale
阿寨	locale
桥南	locale
安顺西	locale
大庆	locale
九龙山	locale
新安县	locale
尾亚	locale
陈家湾	locale
谷城	locale
牧原	locale
花土坡	locale
磁山	locale
福兴地	locale
长沙坝	locale
青沟子	locale
小岭	locale
关岭	locale
大连	locale
布列开	locale
后寨	locale
沙坪坝	locale
和硕	locale
大板	locale
河间西	locale
斗沟子	locale
观音阁	locale
新城川	locale
密云	locale
白沙铺	locale
长农	locale
郑州东	locale
民乐	locale
***	locale
渠黎	locale
潜江	locale
隆安	locale
曲江	locale
三江镇	locale
下坡处	locale
高山子	locale
桂林北	locale
玉门	locale
何三家	locale
鱼嘴	locale
五家	locale
吉祥峰	locale
峙滩	locale
汇南	locale
临汝镇	locale
蛟河	locale
牙拉盖图	locale
八达岭	locale
安庆沟	locale
泉阳	locale
枣强	locale
彬县	locale
刘家沟	locale
霸州西	locale
百浪	locale
桓龙湖	locale
戎庄	locale
南桥	locale
四会	locale
驻马店	locale
惠东	locale
高州	locale
郜营	locale
栋青树	locale
胡家营	locale
上高镇	locale
铁岭	locale
道清	locale
满村	locale
重庆	locale
赤峰西	locale
广汉北	locale
厦门	locale
潮水	locale
东湾	locale
谢家镇	locale
清泰坡	locale
豆张庄	locale
三门县	locale
上石	locale
新泉	locale
麻城北	locale
迤资	locale
长潭沟	locale
龙江	locale
杨岗	locale
福巨	locale
福山寺	locale
通途	locale
桃园	locale
五常	locale
花楼坝	locale
肇庆东	locale
公庙子	locale
新立屯	locale
佛山西	locale
柴河	locale
包头北	locale
清风店	locale
新民桥	locale
成高子	locale
定兴	locale
洪安乡	locale
商都	locale
花山南	locale
巩义南	locale
青龙桥	locale
秋梨沟	locale
金山湾	locale
王兆屯	locale
绍兴北	locale
静海	locale
南雄	locale
大成	locale
武安	locale
河	locale
毛坝关	locale
阿金	locale
上杭	locale
八都	locale
富裕	locale
伊敏	locale
知字井	locale
江门	locale
潼南	locale
西阳岔	locale
大水	locale
中卫	locale
蜀河	locale
朝天南	locale
刘屯	locale
蚌埠	locale
建湖	locale
台州	locale
龙船	locale
谷陇	locale
七里河	locale
南康	locale
小高	locale
斑竹园	locale
张辛	locale
普湾	locale
三队	locale
揭阳	locale
唐家沱	locale
渭南	locale
白海	locale
韶关东	locale
龙池	locale
神州	locale
清河	locale
湘乡	locale
庄桥	locale
弋阳东	locale
石河子	locale
别山	locale
新肇	locale
石崖寨	locale
滥坝	locale
成都东	locale
柯坪	locale
武夷山东	locale
长汀镇	locale
佛岭	locale
镇西	locale
龙口	locale
谭家井	locale
上谷	locale
黄羊湾	locale
汕尾	locale
龙岩	locale
郑州	locale
漳州	locale
老河口东	locale
新彦	locale
阿达日格	locale
旌德	locale
伊宁	locale
广兴	locale
迤那	locale
龙里北	locale
星耀	locale
伊列克得	locale
三界	locale
太岭	locale
合浦	locale
安图西	locale
南充东	locale
泰宁	locale
穰东	locale
西街口	locale
何刘	locale
敬梓场	locale
云霄	locale
二营	locale
霞洞	locale
和什托洛盖	locale
长春南	locale
光明	locale
三关口	locale
奎山	locale
攀枝花	locale
道仑郭勒	locale
公主岭	locale
大理	locale
铜仁南	locale
乐居	locale
双鸭山	locale
舒城	locale
大田山	locale
绩溪县	locale
六地沟	locale
吉安	locale
南台	locale
前山	locale
白马井	locale
双柳	locale
田庄镇	locale
杨漩	locale
团山	locale
顺德学院	locale
海坨子	locale
美岱召	locale
大陆号	locale
海阳	locale
荷马岭	locale
德兴	locale
宣汉	locale
化州	locale
灵武	locale
天峻	locale
珠海	locale
******	locale
彭山	locale
*****	locale
荷塘	locale
萍乡	locale
东大坝	locale
滁州	locale
天河街	locale
南陵	locale
东戌	locale
长征	locale
石柱槽	locale
吉首	locale
贵溪	locale
水沟	locale
羊圈子	locale
深圳	locale
铜陵东	locale
武威南	locale
乌拉山	locale
超梁沟	locale
施家嘴	locale
宽甸	locale
渭津	locale
常德	locale
博兴	locale
北兴安	locale
狮子营	locale
西柳	locale
罗坊	locale
两河口	locale
狮山北	locale
棋子湾	locale
香樟路	locale
梅州	locale
碧江	locale
昌图	locale
临湘	locale
北屯镇	locale
阿南庄	locale
明安	locale
马田墟	locale
北头河	locale
宁海	locale
安达	locale
禄丰	locale
清平	locale
××××	locale
敖头	locale
千阳	locale
双河镇	locale
许家屯	locale
板塘	locale
朱家沟	locale
梧州	locale
钱家店	locale
清水县	locale
通县西	locale
五道河	locale
桃山	locale
余姚	locale
株洲南	locale
安顺	locale
羊臼河	locale
冯家坝	locale
对青山	locale
魏家沟	locale
边沟	locale
平凉南	locale
杨陵镇	locale
西斋	locale
江密峰	locale
永昌	locale
张家船	locale
明港东	locale
葆园	locale
新帐房	locale
田阳	locale
塔源	locale
温春	locale
博鳌	locale
溧水	locale
李家河	locale
黄冈西	locale
七台河	locale
双泡子	locale
五林	locale
旗下营	locale
庐江	locale
老哈河	locale
万水泉	locale
古鲁满汗	locale
金山园区	locale
沧口	locale
南召	locale
确山	locale
沿河城	locale
伊图里河	locale
偏店	locale
滕州东	locale
永川	locale
喜鹊乐	locale
高阳镇	locale
元宝山	locale
龙家堡	locale
原林	locale
江门东	locale
周家屯	locale
三汇坝	locale
瓦房店西	locale
硕放	locale
天湖	locale
南阳	locale
屯升	locale
张家口	locale
马盖图	locale
凤凰	locale
枣庄东	locale
张掖	locale
大禾塘	locale
朝阳地	locale
乃林	locale
美兰	locale
平顶山西	locale
北流	locale
园墩	locale
银川南	locale
乐昌	locale
棕溪	locale
清涧县	locale
磨心坡	locale
枣阳	locale
创业村	locale
塘库	locale
容县	locale
平河口	locale
怀集	locale
濑湍	locale
东安	locale
恒地营	locale
元龙	locale
五华山	locale
忠工屯	locale
大旺	locale
沙马拉达	locale
泗县	locale
伊春	locale
松江南	locale
泰来	locale
永和	locale
余粮堡	locale
上海虹桥	locale
古田北	locale
石峡子	locale
沙河口	locale
五女山	locale
集安	locale
宣威	locale
宁波东	locale
田坝	locale
如皋	locale
河洛营	locale
鸡东	locale
横岗	locale
长寿北	locale
三塘铺	locale
南靖	locale
平度	locale
范镇	locale
万州	locale
海拉尔	locale
西湾堡	locale
四老沟	locale
小关溪	locale
刁家段	locale
崔黄口	locale
归流河	locale
柳家庄	locale
清水沟	locale
金杖子	locale
富林	locale
雅鲁	locale
朝阳	locale
西南杖子	locale
来宾	locale
军粮城北	locale
莒南	locale
里腊	locale
东壕	locale
柏村	locale
青龙寺	locale
富源北	locale
鹰潭北	locale
蓟州	locale
尖峰	locale
坪上	locale
青州市	locale
汉中	locale
大冶	locale
慈城	locale
兴和	locale
门达	locale
京山	locale
郁南	locale
马鞍山	locale
运粮河	locale
羊木	locale
大王滩	locale
吐哈	locale
扎罗木得	locale
南江口	locale
银瓶	locale
内江北	locale
永泰	locale
哈玛	locale
六个鸡	locale
杭锦旗	locale
兰岭	locale
安定	locale
咋子	locale
南芬北	locale
淮安	locale
绍兴东	locale
焉耆	locale
韶山南	locale
暮云	locale
太平川	locale
杏树屯	locale
朱坡	locale
莱芜西	locale
东营子	locale
卓山	locale
武昌南	locale
安德	locale
金河	locale
车转湾	locale
武义北	locale
铁口	locale
翠岗	locale
广汉	locale
明城	locale
太平庄	locale
阳谷	locale
西斗铺	locale
金山卫	locale
敖力布告	locale
九龙塘	locale
二密河	locale
塔崖驿	locale
井店	locale
罗源	locale
蒲城东	locale
竹园坝	locale
坡底下	locale
林盛堡	locale
盘古	locale
筹洞	locale
瓦窑堡	locale
孟溪	locale
涪陵西	locale
桐木寨	locale
小白	locale
瑞昌	locale
信阳	locale
米脂	locale
乐跃	locale
漳州东	locale
黑龙堰	locale
丙谷	locale
公营子	locale
渤海	locale
梅陇	locale
登瀛崖	locale
牛坪子	locale
富庄子	locale
张巷	locale
章古台	locale
石城	locale
承德	locale
抚顺城	locale
旗下营东	locale
朝阳村	locale
廉桥	locale
乐善村	locale
漠河	locale
本溪	locale
盘州	locale
上店	locale
早阳	locale
梅河口	locale
滦平	locale
刁河店	locale
珠海北	locale
海晏	locale
凤凰山	locale
兴义	locale
栏杆滩	locale
安北	locale
甘洛	locale
苍溪	locale
林源	locale
赫尔洪得	locale
东来	locale
临江寺	locale
鄯善	locale
华蓥	locale
巴彦高勒	locale
珲春	locale
上营	locale
广元南	locale
新站	locale
通沟	locale
平台	locale
抚顺北	locale
夏坝	locale
丙午	locale
鹰潭	locale
杨杖子	locale
龙川	locale
光明城	locale
扶余	locale
汤逊湖	locale
娘娘庙	locale
五原	locale
信宜	locale
古城湾	locale
霍尔果斯	locale
大兴沟	locale
日照	locale
友好	locale
高要	locale
棋盘	locale
黑河	locale
南溪沟	locale
牛家	locale
老堡	locale
麻栗	locale
周村	locale
南张村	locale
黄陵	locale
全州南	locale
鱼卡	locale
格尔木	locale
南通	locale
七眼桥	locale
新郑	locale
扶余北	locale
大平房	locale
阜新南	locale
谭家坝	locale
白音胡硕	locale
渠旧	locale
中小所	depart
娄山关	locale
瓦屋山	locale
二岔	locale
小花果	locale
玛纳斯	locale
孟家岗	locale
鄄城	locale
马皇	locale
广德号	locale
新保安	locale
乌兰哈达	locale
八角台	locale
佛峪	locale
梁平	locale
金钟	locale
云居寺	locale
石桥镇	locale
坡底村	locale
杨柳青	locale
抚州	locale
新丰镇	locale
大柴旦	locale
完县	locale
凭祥	locale
老营	locale
大方南	locale
牧羊村	locale
大垌	locale
三把火	locale
百宜	locale
渡市	locale
无为	locale
河汤沟	locale
小唐庄	locale
子长	locale
峨眉山	locale
泊头	locale
隆化	locale
王家营西	locale
泉水	locale
全胜	locale
墙子路	locale
横峰	locale
礼州	locale
将军河	locale
平坝	locale
白水镇	locale
平坊	locale
襄樊	locale
洛阳北	locale
三十家	locale
永乐店	locale
****	locale
漠河县	locale
零陵	locale
艾家村	locale
功塘	locale
大拟	locale
瓦祖	locale
大连北	locale
碧鸡关	locale
金字牌	locale
台前	locale
沛屯	locale
三堆子	locale
上园	locale
云东海	locale
翠峰	locale
阿城	locale
民和南	locale
太平店	locale
朝格温多尔	locale
西麻山	locale
景泰	locale
哈达阳	locale
丰城南	locale
纳雍	locale
霸州	locale
青城山	locale
西索木	locale
冯屯	locale
襄汾西	locale
张集	locale
塘头厦	locale
八家子	locale
古浪	locale
青堆子	locale
昭山	locale
侯家坪	locale
中滩	locale
信阳东	locale
沙溪坝	locale
龙田	locale
白音察干	locale
车岗	locale
坪石	locale
邵家堂	locale
马回岭	locale
窑上	locale
牙克石	locale
宜耐	locale
杜拉尔	locale
沙城	locale
白山乡	locale
孔家庄	locale
永济北	locale
乌西	locale
双阳	locale
皋兰	locale
高台	locale
嘉兴	locale
康金井	locale
打羊	locale
香兰	locale
古莲	locale
宜昌东	locale
白桦排	locale
牙屯堡	locale
郭磊庄	locale
淮滨	locale
大徐屯	locale
嘉善	locale
白塔埠	locale
大观岭	locale
定陶	locale
勉县	locale
西永	locale
轸溪	locale
乾县	locale
太平镇	locale
东光	locale
怀柔	locale
建设	locale
通辽	locale
南平南	locale
九标	locale
八村	locale
河阳	locale
厚坝	locale
罗江	locale
九江	locale
下峪口	locale
三江南	locale
蔺家楼	locale
龙潭	locale
耒阳	locale
醪桥	locale
松树坡	locale
桥湾	locale
大其拉哈	locale
贵定北	locale
西丰	locale
宝木吐	locale
藁城	locale
白山市	locale
芷江	locale
遂平	locale
东沟门	locale
从江	locale
虎山	locale
三原	locale
罗敷	locale
丰都	locale
郴州西	locale
闹海营	locale
振德	locale
营口	locale
自贡	locale
河源	locale
两所屯	locale
平昌	locale
达拉特旗	locale
新固镇	locale
伏牛溪	locale
桥头集	locale
弥渡	locale
东海县	locale
乌川	locale
乌兰浩特	locale
哈达	locale
韶山	locale
平原堡	locale
建宁县北	locale
青神	locale
濉溪	locale
旧庄窝	locale
广德	locale
大孤山	locale
临西	locale
石子坝	locale
庙山	locale
吉文	locale
龙家营所	depart
淮南	locale
冠朝	locale
沈阳东	locale
十里坪	locale
渭南镇	locale
德清	locale
姚千户屯	locale
永定	locale
金堂	locale
华容东	locale
四合永	locale
仙游	locale
大扬气	locale
乌兰花	locale
白鹿塘	locale
太湖	locale
草河口	locale
蓬溪	locale
南岸坝	locale
威舍	locale
呼兰	locale
俞冲	locale
龙游	locale
海宁西	locale
大理东	locale
独立屯	locale
叶集	locale
鸳鸯镇	locale
芦台	locale
下塘集	locale
白奎堡	locale
新化南	locale
牡丹江	locale
黄石东	locale
大岗	locale
哈尔巴岭	locale
丰乐镇	locale
巨宝	locale
弓棚子	locale
康庄	locale
落坡岭	locale
树木岭	locale
无锡东	locale
长坡岭	locale
衡水	locale
钟杖子	locale
益阳	locale
亚布力	locale
周口	locale
深圳坪山	locale
开鲁	locale
三介海子	locale
三阳川	locale
曲靖北	locale
西六方	locale
马桥河	locale
内江南	locale
海口	locale
金口河	locale
永甸	locale
柏林	locale
宜兴	locale
广通	locale
梁家坝	locale
工农湖	locale
萧家村	locale
泥河子	locale
巴伦台	locale
常平东	locale
毛坝	locale
额济纳	locale
无锡	locale
沧州西	locale
朝天	locale
昌黎	locale
三河县	locale
三岔	locale
十家子	locale
胶州北	locale
海东西	locale
么铺	locale
宝鸡南	locale
锡林呼都嘎	locale
潢川	locale
图呼木	locale
祁门	locale
新乡	locale
通州西	locale
青田	locale
黑山	locale
凌家场	locale
鄂州	locale
黄	locale
一面坡	locale
清水北	locale
长葛	locale
德仁	locale
达拉特西	locale
银川	locale
津沪所	depart
三明	locale
讷尔克气	locale
大通西	locale
长基	locale
英德	locale
峰洞	locale
三家子	locale
平顶山	locale
祥云	locale
天津北	locale
宁安	locale
那曲	locale
麻虎	locale
江油	locale
舍伯吐	locale
安亭	locale
打柴沟	locale
防城	locale
孟庙	locale
沙湾	locale
阿尔山	locale
仙村	locale
道德	locale
陇县	locale
广南县	locale
万庄	locale
徐塘庄	locale
低窝铺	locale
汨罗	locale
瓦房店	locale
井南	locale
南昌西	locale
龙沟	locale
石郎庄	locale
皮山	locale
得胜台	locale
八苏木	locale
昭通南	locale
鸭园	locale
长河坝	locale
滨州	locale
石燕桥	locale
鱼泉	locale
黄流	locale
金山屯	locale
潮州	locale
武汉北	locale
牛汾台	locale
吉林西	locale
密地	locale
双子河	locale
汤旺河	locale
尼波	locale
保康	locale
花棚子	locale
陵丘	locale
精河南	locale
乐化	locale
福临堡	locale
大安	locale
老爷岭	locale
喀喇其	locale
牛叫河	locale
仲恺	locale
仁寿村	locale
松村	locale
茶卡	locale
茶陵	locale
梅花山	locale
旅顺	locale
隆昌	locale
白水	locale
叶城	locale
奇峰塔	locale
太洪	locale
桦南	locale
合川	locale
正镶白旗	locale
杜家	locale
济宁	locale
莲塘	locale
柯柯	locale
沐滂	locale
榆树	locale
山湾子	locale
靖西	locale
际坑口	locale
宁村	locale
豆沙关	locale
永州	locale
下台子	locale
埃岱	locale
滨海	locale
褚家湾	locale
四方台	locale
生芝渠	locale
达县	locale
徐水	locale
加劳	locale
惠安	locale
木头营子	locale
武汉	locale
永宁镇	locale
海石湾	locale
柯坦	locale
卡伦	locale
玉山南	locale
岷县	locale
双凤驿	locale
滩头	locale
香坊	locale
燕山	locale
墟沟	locale
蔡家坡	locale
曹家坝	locale
平安	locale
龙华	locale
神木	locale
锦州	locale
宝拉格	locale
民权北	locale
云浮东	locale
吉舒	locale
羊坪	locale
义井	locale
合肥北城	locale
石花	locale
吐鲁番	locale
马兰	locale
西胡尔清	locale
曾家坪子	locale
岳阳东	locale
刘沟	locale
湘潭北	locale
鳌江	locale
阿克苏	locale
张桥	locale
韩堂	locale
东乡	locale
庙头	locale
上虞	locale
荣昌	locale
牛家营子	locale
克利	locale
统军庄	locale
砚川	locale
庙坝	locale
北碚	locale
南宫山	locale
阜新	locale
顺昌	locale
古丈	locale
二井	locale
乌兰	locale
织金	locale
天津南	locale
坦途	locale
漳平	locale
敖汉	locale
福清	locale
灵山	locale
侯杖子	locale
尔赛河	locale
梅村	locale
枝江北	locale
通北	locale
鲍峡	locale
沙沙坡	locale
草店	locale
鹿寨北	locale
华山北	locale
菇园	locale
板石河	locale
中宁南	locale
聊城	locale
安化	locale
瓦窑田	locale
春风	locale
北白	locale
连珠山	locale
嘉峪关	locale
溆浦	locale
赤峰	locale
汗苏鲁	locale
彭州	locale
小董	locale
林子头	locale
郯城	locale
松原北	locale
哈密南	locale
阳平关	locale
清河门	locale
畲江	locale
宿州东	locale
罗文	locale
铁西	locale
永川东	locale
东岔	locale
滁州北	locale
绥化	locale
当阳	locale
阿尔山北	locale
鲁山	locale
洛阳东	locale
高崎	locale
大安北	locale
驻马店西	locale
长庆桥	locale
项城	locale
卢龙	locale
桥头	locale
兴安岭	locale
三江县	locale
张三营	locale
伊拉哈	locale
红安	locale
太阳沟	locale
城子坦	locale
曲水	locale
金华	locale
阿克陶	locale
安康	locale
庆阳山	locale
伊川	locale
经久	locale
依安	locale
聂河	locale
定州	locale
大元	locale
石林西	locale
萧山	locale
苔青	locale
呈贡	locale
葫芦岛北	locale
龙骨甸	locale
江北	locale
二龙屯	locale
红山	locale
一间堡	locale
大兴	locale
捞刀河	locale
安家湾	locale
福州	locale
涿州东	locale
赤峰东	locale
沙湾县	locale
沙河	locale
黑岗	locale
茅草坪	locale
阳信	locale
高塘	locale
黄土坡	locale
让湖路	locale
北台	locale
三家寨	locale
三营图	locale
明水	locale
资中北	locale
德清西	locale
林海	locale
淮北	locale
金华南所	depart
曹县	locale
湖南	locale
鹤山	locale
白音特拉	locale
雨格	locale
宝清	locale
密山西	locale
北屯	locale
钟家村	locale
融安	locale
新阳镇	locale
喇嘛山	locale
菏泽	locale
寒岭	locale
喇嘛甸	locale
邯郸东	locale
油溪	locale
汤头沟	locale
硬石岭	locale
绥中	locale
龙凤场	locale
燕岗	locale
图们	locale
头道桥	locale
留庄	locale
南宁南	locale
布吉	locale
宝鸡	locale
黄陵南	locale
车墩	locale
黄许镇	locale
井头墟	locale
林口	locale
新安江	locale
息县	locale
西林	locale
王楼	locale
小喜村	locale
八面通	locale
平安镇	locale
马莲河	locale
大英	locale
两家	locale
算王庄	locale
海湾	locale
三间房	locale
沈丘	locale
榆林	locale
苇子沟	locale
楚山	locale
郑家屯	locale
黄家坝	locale
金银川	locale
呼和浩特	locale
贵阳北	locale
衢州	locale
化德	locale
麻江	locale
东方	locale
三十里堡	locale
北京北	locale
汝箕沟	locale
嘎什吐	locale
松坎	locale
长甸	locale
兰棱	locale
来舟	locale
铁岭西	locale
鼎湖山	locale
白音华南	locale
开阳	locale
黄泥河	locale
馗塘	locale
新凉	locale
荒沟西	locale
同江	locale
聊城东	locale
双龙山	locale
离堆公园	locale
穆棱	locale
水富	locale
都匀	locale
内江东	locale
内江	locale
宣化	locale
赛乌苏	locale
下马塘	locale
沟帮子	locale
新津	locale
中寨	locale
哈拉海	locale
大营子	locale
郑集	locale
梁底下	locale
藤县	locale
十渡	locale
石磷	locale
罗城	locale
彭城	locale
长江埠	locale
苏雄	locale
十里村	locale
幽州	locale
太和	locale
柳园	locale
龙头寨	locale
田梁子	locale
高密	locale
宜春	locale
小南海	locale
昆山	locale
弋江	locale
李家	locale
勉西	locale
七甸	locale
后湖	locale
宣家沟	locale
女儿河	locale
泰和	locale
商南	locale
芝阳	locale
三水北	locale
苇河	locale
宁东	locale
得耳布尔	locale
革镇堡	locale
金昌	locale
石丫口	locale
丹徒	locale
达拉滨	locale
大渡口	locale
大口钦	locale
黄沙河	locale
绣峰	locale
鹰手营子	locale
商酒务	locale
果松	locale
保健	locale
贵港	locale
崔家营子	locale
湾沟	locale
东辛庄	locale
中谊村	locale
石门县北	locale
五里冲	locale
南兴安	locale
唐山	locale
滨海北	locale
瑞安	locale
千河	locale
通道	locale
齐齐哈尔	locale
高碑店东	locale
满洲里	locale
克山	locale
新立镇	locale
澧县	locale
宿松	locale
新乐	locale
营北	locale
黄松甸	locale
仙人桥	locale
临清	locale
大旧庄	locale
黔江	locale
新祺周	locale
赣县	locale
影壁山	locale
池州	locale
高邑西	locale
汉寿	locale
中台子	locale
牛街庄	locale
汉口	locale
庙台子	locale
西岭口	locale
徽县	locale
外洋	locale
楚鲁图	locale
歙县	locale
下藤桥	locale
沟口	locale
腰栈	locale
贺日斯台	locale
坂田	locale
红石	locale
泽普	locale
固原	locale
蟠龙镇	locale
旗山	locale
尹地	locale
墨玉	locale
仁布	locale
遵义北	locale
理家坪	locale
龙山镇	locale
合肥南	locale
半截河	locale
凤凰机场	locale
王府	locale
即墨	locale
春湾	locale
三江	locale
芦溪	locale
谷硐	locale
富拉尔基	locale
三门峡西	locale
会昌北	locale
锡林浩特	locale
双安屯	locale
茂名东	locale
汤池	locale
松岭	locale
向阳村	locale
沙园	locale
乌兰丘	locale
三岔口	locale
栗木	locale
淄博	locale
朱杨溪	locale
辰溪	locale
新江	locale
元氏	locale
哈拉	locale
普定	locale
阜宁	locale
南朗	locale
雁石	locale
济南东	locale
三十三号	locale
百色	locale
小合隆	locale
前进镇	locale
青龙山	locale
小屯街	locale
寨隆	locale
汕头	locale
画桥	locale
墨池坝	locale
磨盘山	locale
京津所	depart
东戴河	locale
沭阳	locale
邳县	locale
楚雄	locale
安溪	locale
流水沟	locale
林村	locale
临巴溪	locale
昆阳	locale
闻喜西	locale
前苇塘	locale
定州东	locale
图强	locale
黄口	locale
甘草店	locale
连江	locale
拉鲊	locale
磨滩	locale
伊宁东	locale
蔡山	locale
交界	locale
陵城	locale
石坝	locale
曹王	locale
田师府	locale
桂平	locale
扎赉诺尔	locale
凯里南	locale
聊城北	locale
太阳升	locale
连云港	locale
南仇	locale
中山北	locale
乐坪	locale
东至	locale
蕉溪	locale
固镇	locale
水源	locale
永康	locale
兴凯	locale
永平	locale
孤山口	locale
崔寨	locale
临川	locale
安口窑	locale
三源浦	locale
安阳	locale
陆丰	locale
七营	locale
遥林	locale
圣浪	locale
新安庄	locale
小池口	locale
西里	locale
东胜西	locale
庆盛	locale
大桥	locale
清河城	locale
子洲	locale
古城镇	locale
平岗	locale
夹心子	locale
花桥	locale
能家	locale
吉新河	locale
湖口	locale
宜山	locale
越西	locale
东升	locale
乌鲁布铁	locale
罕达盖	locale
老岭	locale
驻马哨	locale
和龙	locale
柯桥	locale
黄石北	locale
朱日和	locale
天桥沟	locale
桑园子	locale
邓家村	locale
甘河	locale
开道	locale
洪洞西	locale
艾不盖	locale
红花铺	locale
定西北	locale
佳木斯	locale
福州南	locale
德昌	locale
羊者窝	locale
阿湖镇	locale
眉山东	locale
中华门	locale
达盖	locale
联合乡	locale
孙吴	locale
黑水	locale
马鞍山东	locale
公主埂	locale
金沟屯	locale
南店	locale
布敦化	locale
平庄	locale
温岭	locale
柴岗	locale
西宁	locale
黄花筒	locale
哈业胡同	locale
李家湾	locale
大虎山	locale
张掖西	locale
万隆	locale
长沙南	locale
衡山西	locale
衙门庙	locale
钦州	locale
哈川	locale
镇江南	locale
胡乐	locale
普兰店	locale
马场	locale
广安	locale
茅岭	locale
土桥子	locale
蒙自	locale
沁阳	locale
白源	locale
玉田县	locale
洮南	locale
磁县	locale
新和	locale
韩麻营	locale
长汀	locale
惠山	locale
神树	locale
司家岭	locale
麻城	locale
宝老山	locale
定远	locale
伊敏索木	locale
坂尾	locale
天门	locale
光山	locale
克一河	locale
商城	locale
田东北	locale
烟筒屯	locale
艾河	locale
大关	locale
杏树	locale
南宫东	locale
晏城北	locale
盐城	locale
资中	locale
新天	locale
霍林郭勒	locale
史口	locale
绿潭	locale
月亮田	locale
陵水	locale
察素齐	locale
海伦	locale
田家沟	locale
平湖南	locale
普济	locale
大乌苏	locale
营盘水	locale
新杖子	locale
炎方	locale
永安	locale
道镇	locale
流山	locale
古田会址	locale
洋河	locale
绍兴	locale
蒲圻	locale
信丰	locale
洛满	locale
八面城	locale
安仁	locale
温州南	locale
巴山	locale
古田	locale
常庄	locale
沙岭子西	locale
塔河	locale
东兴	locale
芦沟	locale
桑根达来	locale
新贤城	locale
漳县	locale
绩溪北	locale
民权	locale
太平岭	locale
彰明	locale
查干湖	locale
琼海	locale
新兴县	locale
修武	locale
延安北	locale
白果	locale
资阳北	locale
都格	locale
渡口	locale
冷水江东	locale
丰镇	locale
西安南	locale
文昌	locale
茨冲	locale
新华	locale
金林	locale
柳河	locale
汉川	locale
杨树湾	locale
小扬气	locale
常州北	locale
清水	locale
庙城	locale
樟树东	locale
承德东	locale
盘锦	locale
呼图壁	locale
虞城县	locale
合阳	locale
邹城	locale
奉化	locale
大盘石	locale
石泉县	locale
湖北	locale
新晃西	locale
江山	locale
呼鲁斯太	locale
厂汗	locale
玉屏	locale
于家堡	locale
四家	locale
安多	locale
唐家湾	locale
汝阳	locale
怀化南	locale
桃村北	locale
呼和浩特东	locale
莫尔道嘎	locale
福溪	locale
关寨	locale
凌源东	locale
鞍山	locale
大良	locale
上海	locale
弯道	locale
阳澄湖	locale
平田	locale
孝感东	locale
新兴场	locale
豆坝	locale
龙凤	locale
凭祥北	locale
花园口	locale
墨冲	locale
松树林	locale
江都	locale
黄山	locale
和静	locale
大荔	locale
沛县	locale
王堂	locale
四道沟	locale
衡山	locale
孙镇	locale
莲江口	locale
鹿寨	locale
洞子崖	locale
广水	locale
烟溪	locale
背荫河	locale
茶镇	locale
晋中	locale
孤家子	locale
徐州	locale
抚宁	locale
资阳	locale
马三家	locale
衡阳	locale
西乌旗	locale
亚布力南	locale
东戍	locale
小市	locale
瑞金	locale
歪头山	locale
滦县	locale
阳新	locale
恭城	locale
三家店	locale
保定	locale
龙井	locale
玉林山	locale
万源	locale
陇南	locale
江永	locale
三合庄	locale
安富镇	locale
柳江	locale
衡阳东	locale
高谷	locale
哈力图	locale
准沙日乌苏	locale
自贡南	locale
兰溪	locale
二道沟门	locale
昆明西	locale
松原	locale
丹霞山	locale
建三江	locale
文庄村	locale
南阳寨	locale
石家庄北	locale
毛告吐	locale
鲇鱼山	locale
烟台南	locale
白塔村	locale
火炬沟	locale
资溪	locale
大口屯	locale
深州	locale
二连	locale
文安	locale
马棚	locale
巴中	locale
红花塘	locale
常州	locale
新墟	locale
大城子	locale
井冈山	locale
南木	locale
缙云西	locale
漫水湾	locale
呼中	locale
江所田	locale
潘家店	locale
新余北	locale
麻阳	locale
阿木尔	locale
保定东	locale
端州	locale
东胜	locale
岩寺	locale
盐津北	locale
光泽	locale
仪征	locale
兖州	locale
获嘉	locale
南安	locale
兰家屯	locale
鲘门	locale
宿州	locale
水泉	locale
义马	locale
枣庄	locale
段甲岭	locale
绍水	locale
登沙河	locale
霍城	locale
普安	locale
陆良	locale
捏掌	locale
黄洋	locale
博乐	locale
新邱	locale
王杨	locale
静岭	locale
鄂州东	locale
阿龙山	locale
元谋	locale
葫芦	locale
赤木岭	locale
阆中	locale
靖远	locale
官厅	locale
鹤壁	locale
富宁	locale
完工	locale
大石头	locale
昭通	locale
望都	locale
双丰	locale
定南	locale
庙下	locale
皇姑屯	locale
亚复	locale
韩城	locale
襄河	locale
老坪坝	locale
木戛	locale
北宅	locale
张家口南	locale
石板滩	locale
镇江	locale
友谊水库	locale
龙嘉	locale
轮台	locale
古坡	locale
冕宁	locale
平坝南	locale
浮图峪	locale
望亭	locale
扎赉诺尔西	locale
新南沟	locale
和田	locale
晋州	locale
河口南	locale
锡铁山	locale
洞庙河	locale
口前	locale
南观村	locale
老松岭	locale
虎峰	locale
玉山	locale
合肥	locale
牛耳河	locale
炉桥	locale
克拉玛依	locale
文登东	locale
东佳木斯	locale
绅坊	locale
将乐	locale
余杭	locale
林家台	locale
随州	locale
柳沟	locale
乳山	locale
建始	locale
七家子	locale
梁堤头	locale
郫县西	locale
桃村	locale
黟县	locale
安龙	locale
待王	locale
昌图西	locale
龙塘坝	locale
哈密东	locale
涵江	locale
高头	locale
徐家坪	locale
广宁	locale
通渭	locale
松林	locale
莱西	locale
泰康	locale
西陌堂所	depart
良各庄	locale
八庙	locale
桥北	locale
北屯市	locale
遂宁	locale
涡阳	locale
秦安	locale
王岗	locale
二道沟	locale
冉家河	locale
银城铺	locale
小路溪	locale
乌兰昭	locale
农乐	locale
汤原	locale
抚州东	locale
修武西	locale
孟津	locale
蛤蟆塘	locale
木里图	locale
大红旗	locale
惠州西站	locale
桐柏站	locale
青龙站	locale
格以头站	locale
遂溪站	locale
武胜站	locale
石岘站	locale
怀化站	locale
大雁站	locale
兰考站	locale
高林屯站	locale
靖宇站	locale
沙海站	locale
深河站	locale
卫辉站	locale
黄羊镇站	locale
协荣站	locale
李旺站	locale
横沥站	locale
蚌埠南站	locale
辰清站	locale
金家店站	locale
木竹河站	locale
小河镇站	locale
威海站	locale
塔哈站	locale
永登站	locale
东坝站	locale
小河口站	locale
商洛站	locale
甘泉北站	locale
焦作站	locale
松韶关站	locale
紫荆关站	locale
查布嘎站	locale
月华站	locale
西固城站	locale
万宁站	locale
五五站	locale
二塘区站	locale
棋梓桥站	locale
如东站	locale
雁荡山站	locale
沙岭庄站	locale
金沙站	locale
磨刀石站	locale
高店铺站	locale
海阳北站	locale
通化县站	locale
里木店站	locale
武昌站	locale
达州站	locale
暖泉站	locale
上街站	locale
广宁寺站	locale
兴泉堡站	locale
东明村站	locale
下普雄站	locale
简阳站	locale
吉林站	locale
玉溪站	locale
青岛北站	locale
北台子站	locale
密山站	locale
小新街站	locale
金山北站	locale
白浪站	locale
昌乐站	locale
永宁站	locale
春阳站	locale
前卫站	locale
黑老湾站	locale
青山堡站	locale
王庄站	locale
岳家井站	locale
窑村站	locale
苏尼特左旗站	locale
曲家店站	locale
永寿站	locale
永胜站	locale
徐家站	locale
沙岭子站	locale
魏善庄站	locale
新洲站	locale
重庆东站	locale
德阳站	locale
盐津站	locale
覃家坝站	locale
南部站	locale
邓州站	locale
螺山站	locale
前锋站	locale
河市坝站	locale
西小召站	locale
雷州站	locale
康城站	locale
夏格庄站	locale
阎良站	locale
株洲站	locale
新余站	locale
老王洞站	locale
耿坡站	locale
甘棠站	locale
中川机场站	locale
斜河涧站	locale
齐哈日格图站	locale
下仓站	locale
师宗站	locale
草六格尔站	locale
邵阳站	locale
申家店站	locale
歙县北站	locale
溆浦南站	locale
莱阳站	locale
戚墅堰站	locale
土门子站	locale
小榆树站	locale
伊通站	locale
拉白站	locale
左家站	locale
南峪站	locale
孝感北站	locale
开封站	locale
南票站	locale
打兔寨站	locale
贵阳站	locale
彭泽站	locale
商丘北站	locale
长春站	locale
洛西站	locale
咸宁北站	locale
石长站	locale
南充站	locale
甘谷站	locale
低庄站	locale
浦江站	locale
南仓所站	locale
浮梁站	locale
悬钟站	locale
桐梓站	locale
广安南站	locale
泰安站	locale
东边井站	locale
贲红站	locale
*******站	locale
砬子河站	locale
萍乡北站	locale
二龙站	locale
宽沟站	locale
罗山站	locale
邢台站	locale
三堂集站	locale
小城站	locale
延安站	locale
新晃站	locale
尼日站	locale
冷水站	locale
南京西站	locale
长临河站	locale
霞西站	locale
白沙站	locale
丰水村站	locale
璧山站	locale
武山站	locale
松树站	locale
大青沟站	locale
朗乡站	locale
建瓯站	locale
黄陂站	locale
耒阳西站	locale
中宁东站	locale
银浪站	locale
扎鲁特站	locale
福生庄站	locale
经棚站	locale
土牧尔台站	locale
兰滩站	locale
蒙渡站	locale
长阳站	locale
双辽站	locale
醴陵东站	locale
丰广站	locale
湘府路站	locale
新林站	locale
陶思浩站	locale
一四二公里站	locale
新安站	locale
肥东站	locale
高潭子站	locale
黄山北站	locale
庙岭站	locale
水城站	locale
岭北站	locale
成都南站	locale
巴楚站	locale
樟树站	locale
大石寨站	locale
永安乡站	locale
哈福站	locale
杜赵站	locale
莱芜东站	locale
永嘉站	locale
屯沟湾站	locale
塔山站	locale
丁家营站	locale
西峡站	locale
哈尔滨站	locale
大东站	locale
丹阳站	locale
朱亭站	locale
双水站	locale
山市站	locale
凯北站	locale
晏家坝站	locale
维罗站	locale
莆田站	locale
兰岗站	locale
遵义西站	locale
海满站	locale
青水山站	locale
天龙站	locale
狼窝铺站	locale
凤凰城站	locale
汤河站	locale
漯河站	locale
连云港东站	locale
卓资山站	locale
营盘湾站	locale
公主岭南站	locale
红卫坝站	locale
班猫箐站	locale
锦州南站	locale
涞源站	locale
河唇站	locale
融水站	locale
流溪场站	locale
蓝家村站	locale
基长站	locale
小寺沟站	locale
紫阳站	locale
冯家山站	locale
弥勒站	locale
三门峡南站	locale
娄山站	locale
*站	locale
大坑口站	locale
连山关站	locale
关林站	locale
疏勒站	locale
福隆站	locale
安庆西站	locale
五十家子站	locale
营城站	locale
牛心台站	locale
虎门站	locale
九三站	locale
酉阳站	locale
五棵树站	locale
吴家庄站	locale
禹城站	locale
南翔北站	locale
古源站	locale
临河站	locale
石庙沟站	locale
尚家站	locale
石桥子站	locale
涟源站	locale
乌奴耳站	locale
宜春西站	locale
海拉尔东站	locale
汇流河站	locale
曲阜站	locale
瑞昌西站	locale
民福寺站	locale
叶榭站	locale
龙里站	locale
西江站	locale
黄草场站	locale
代马沟站	locale
莒县站	locale
山坡东站	locale
煤山站	locale
下板城站	locale
午汲站	locale
兴业站	locale
麻旺站	locale
延吉站	locale
宋站	locale
杭州站	locale
福田站	locale
济南站	locale
建昌站	locale
建瓯西站	locale
兴隆镇站	locale
向阳镇站	locale
东台站	locale
白村站	locale
集宁站	locale
昆明站	locale
襄樊北站	locale
陈相屯站	locale
界山站	locale
武穴站	locale
临水站	locale
李子沟站	locale
枕头峰站	locale
勃利站	locale
绥德站	locale
新都东站	locale
太要站	locale
田庄站	locale
灵仙庙站	locale
花家庄站	locale
进贤南站	locale
发耳站	locale
长春西站	locale
天府北站	locale
德安站	locale
岔河站	locale
北井子站	locale
荆门站	locale
烟台站	locale
宇宙地站	locale
汉沽站	locale
禄丰南站	locale
宁东南站	locale
丽江站	locale
文地站	locale
大山铺站	locale
西平站	locale
麻栗树站	locale
许昌站	locale
朝阳镇站	locale
劲涛站	locale
陈官营站	locale
牛庄站	locale
安广站	locale
长沙站	locale
韶关站	locale
巨各庄站	locale
海口东站	locale
分宜站	locale
走马岭站	locale
南宁西站	locale
珞璜站	locale
北召店站	locale
山口站	locale
石龙站	locale
李石寨站	locale
汪清站	locale
乐埠站	locale
丰润站	locale
丰顺站	locale
石林南站	locale
巢湖东站	locale
渭南北站	locale
碱柜站	locale
临潼站	locale
明港站	locale
乌龙泉南站	locale
大堡站	locale
桦林站	locale
庆华站	locale
林东站	locale
升昌站	locale
署字井站	locale
慈利站	locale
安阳东站	locale
呼源站	locale
拉萨站	locale
休宁站	locale
塔前站	locale
灵璧站	locale
城阳站	locale
凤阳站	locale
石湖村站	locale
万年站	locale
福德站	locale
高邑站	locale
西安东站	locale
湘潭站	locale
大湾子站	locale
新会站	locale
綦江北站	locale
皇路店站	locale
京寨站	locale
南沟站	locale
大滩站	locale
红寺堡站	locale
清华园站	locale
邳州站	locale
叶茂站	locale
柘车河所站	locale
防城港北站	locale
诏安站	locale
白彦花站	locale
金华西站	locale
萨拉齐站	locale
安靖站	locale
乾安站	locale
福安站	locale
寿昌站	locale
贵阳西站	locale
许三湾站	locale
南宁站	locale
三门峡站	locale
汉源站	locale
来宾北站	locale
利川站	locale
兴国站	locale
花园站	locale
抚远站	locale
白河东站	locale
武店站	locale
石板哨站	locale
华容站	locale
葛根庙站	locale
丽江东站	locale
哈尔滨北站	locale
红房子站	locale
武清站	locale
固始站	locale
东龙站	locale
天桥站	locale
深圳北站	locale
乌海北站	locale
公兴站	locale
滑县南站	locale
柳树屯站	locale
龙洞堡站	locale
南仓站	locale
赤壁北站	locale
塘渡口站	locale
下花园站	locale
亭林站	locale
梨树湾站	locale
三明北站	locale
锦界站	locale
灯塔站	locale
崇左站	locale
彰武站	locale
瓦拉干站	locale
醴陵站	locale
滩头湾站	locale
新窝铺站	locale
北票南站	locale
株洲西站	locale
隆昌北站	locale
兰考南站	locale
新绰源站	locale
乐都南站	locale
路口铺站	locale
寒葱沟站	locale
平顶庙站	locale
银滩站	locale
甸心站	locale
察尔汗站	locale
神木北站	locale
库车站	locale
黑台站	locale
茶条沟站	locale
府谷站	locale
沁河北站	locale
长安镇站	locale
兴和西站	locale
西大庙站	locale
沙村站	locale
新津南站	locale
普洱渡站	locale
广州东站	locale
永丰营站	locale
蕲春站	locale
济源站	locale
石门站	locale
英吉沙站	locale
兰陵北站	locale
湖潮站	locale
五府山站	locale
永福站	locale
江津站	locale
上西铺站	locale
石场站	locale
大湾站	locale
临平站	locale
玉溪西站	locale
独李村站	locale
平庄南站	locale
蔡家沟站	locale
扎音河站	locale
哈尔滨西站	locale
烟筒山站	locale
西大滩站	locale
盘龙城站	locale
三合场站	locale
阿勒泰站	locale
喀拉玉尔滚站	locale
杭州南站	locale
大足南站	locale
十三间房站	locale
富县东站	locale
大石板站	locale
扶绥站	locale
白云鄂博站	locale
权河站	locale
新坪田站	locale
蒙自北站	locale
廊坊北站	locale
连江口站	locale
芨岭站	locale
源迁站	locale
挖色站	locale
绿博园站	locale
广州北站	locale
清原站	locale
德日斯图站	locale
新华屯站	locale
横店站	locale
建水站	locale
严关乡站	locale
镇罗堡站	locale
健民站	locale
阿图什站	locale
猴山站	locale
德保站	locale
两当站	locale
风水沟站	locale
黄柏站	locale
湖头站	locale
白洋淀站	locale
西昌北站	locale
加南站	locale
南城司站	locale
川弓站	locale
纸坊东站	locale
白田坝站	locale
大河坝站	locale
吐鲁番北站	locale
宁波站	locale
桥西站	locale
黄羊滩站	locale
新乡东站	locale
大埔站	locale
红彦站	locale
万乐站	locale
昂昂溪站	locale
临海站	locale
二郎庙站	locale
双桥站	locale
天堂站	locale
南充北站	locale
新干站	locale
滴道站	locale
郑州西站	locale
电白站	locale
道州站	locale
息烽站	locale
朝阳川站	locale
防城港站	locale
敦化站	locale
大磴沟站	locale
襄樊东站	locale
华容南站	locale
大战场站	locale
茂名站	locale
甲堡站	locale
泗水站	locale
倮果站	locale
落垡站	locale
桂林站	locale
黄桶站	locale
库都尔站	locale
刘伟壕站	locale
诸暨站	locale
宁家站	locale
金场堡站	locale
宜宾南站	locale
加格达奇站	locale
丹东站	locale
牛街站	locale
彭山北站	locale
一面山站	locale
黄河景区站	locale
卧龙寺站	locale
碧水站	locale
平凉站	locale
小姑家站	locale
明白村站	locale
乌兰察布站	locale
天岗站	locale
翁通站	locale
洋县站	locale
南京南站	locale
沙坡头站	locale
海龙站	locale
果河站	locale
高碑店站	locale
三都县站	locale
普安县站	locale
贵定南站	locale
青莲站	locale
同心站	locale
乐山北站	locale
云梦站	locale
南尔岗站	locale
沙日乃站	locale
榆树沟站	locale
角美站	locale
武隆站	locale
忙罕屯站	locale
武陟站	locale
麦园站	locale
二道沙河站	locale
虎林站	locale
黄龙站	locale
定边站	locale
平关站	locale
土坎站	locale
南平站	locale
铁佛寺站	locale
东营站	locale
铜陵北站	locale
郴州站	locale
松江站	locale
朱家窑站	locale
十堰站	locale
郭家屯站	locale
马坝站	locale
邵武站	locale
嘎拉德斯汰站	locale
金沙湾站	locale
感德站	locale
红花沟站	locale
中山站	locale
免渡河站	locale
下城子站	locale
格里坪站	locale
小儿坪站	locale
达州东站	locale
姚渡站	locale
普舍寨站	locale
热水站	locale
苟各庄站	locale
鱼儿沟站	locale
彭水站	locale
辽源站	locale
赵光站	locale
娄底站	locale
槐安站	locale
皂角铺站	locale
曲水县站	locale
大西站	locale
了墩站	locale
神峪河站	locale
黑旺站	locale
团结站	locale
新铁村站	locale
邵东站	locale
九里站	locale
钟山西站	locale
密云北站	locale
瓦房站	locale
塘沽站	locale
费县站	locale
闻庄站	locale
回龙坝站	locale
库伦站	locale
大民屯站	locale
十八台站	locale
北仓站	locale
吐列毛杜站	locale
高台南站	locale
临高南站	locale
燕郊站	locale
肥西站	locale
南昌北站	locale
张维屯站	locale
红砂岘站	locale
平洋站	locale
姚安站	locale
朝中站	locale
固城站	locale
深井子站	locale
兴隆店站	locale
东方红站	locale
峻德站	locale
泉州东站	locale
咸宁南站	locale
闵集站	locale
辛集站	locale
九龙站	locale
凤翔站	locale
深圳东站	locale
大郑站	locale
宝丰站	locale
磐安镇站	locale
贺家店站	locale
小月旧站	locale
乐山站	locale
裴德站	locale
什里店站	locale
毕克齐站	locale
眉山站	locale
乐清站	locale
临澧站	locale
红石崖站	locale
沈家河站	locale
绥中北站	locale
大荔北站	locale
松坝站	locale
松桃站	locale
唐官屯站	locale
雁儿崖站	locale
兴安站	locale
渑池南站	locale
宜宾站	locale
张台子站	locale
龙头站	locale
田东站	locale
福海站	locale
老城镇站	locale
梁山站	locale
陶家屯站	locale
绥棱站	locale
唐河站	locale
湛江站	locale
新县站	locale
繁昌北站	locale
苏北站	locale
九台南站	locale
张家界站	locale
绿化站	locale
欧里站	locale
布海站	locale
千岛湖站	locale
东通化站	locale
德州站	locale
韦庄站	locale
高梁铺站	locale
碾子山站	locale
亮甲店站	locale
石门坎站	locale
水洞站	locale
龙门河站	locale
坝梁站	locale
万发屯站	locale
海浪站	locale
查干哈达站	locale
马海站	locale
小箐站	locale
安居站	locale
宾阳站	locale
南河站	locale
青山站	locale
潼关站	locale
长发屯站	locale
沙子河站	locale
南头站	locale
核桃园站	locale
虎尔虎拉站	locale
樟林站	locale
尚武站	locale
牟平站	locale
鹿道站	locale
许昌东站	locale
庆安站	locale
大兴镇站	locale
老莱站	locale
苍南站	locale
滦河站	locale
淮南东站	locale
秦家站	locale
本溪新城站	locale
平安驿站	locale
张寨站	locale
南丹站	locale
杨林站	locale
洛碛站	locale
米易站	locale
繁昌西站	locale
仓山镇站	locale
岐山站	locale
南丰站	locale
金珠站	locale
莫干山站	locale
吉安南站	locale
石头站	locale
长河碥站	locale
朱石寨站	locale
平原站	locale
老羊壕站	locale
岔滩站	locale
庙子沟站	locale
彭阳站	locale
临泽南站	locale
弯站	locale
温根托海站	locale
包官营站	locale
图们北站	locale
干沟站	locale
骆驼巷站	locale
红兴隆站	locale
西昌站	locale
松江河站	locale
高老站	locale
兰州新区站	locale
小金口站	locale
青溪站	locale
昆都庙站	locale
泰州站	locale
高安站	locale
源潭站	locale
临城站	locale
西湖东站	locale
杨家岭站	locale
汇塘河站	locale
羊堡站	locale
土溪站	locale
海安南站	locale
黄站	locale
磨溪站	locale
前榆站	locale
江华站	locale
哈尔滨东站	locale
威宁站	locale
南华北站	locale
夏集站	locale
白合站	locale
富锦站	locale
姜家站	locale
饶阳站	locale
汝州站	locale
石柱县站	locale
塘豹站	locale
盘关站	locale
祁阳站	locale
羊尾哨站	locale
富川站	locale
太阳村站	locale
马架子站	locale
大庆东站	locale
双河口站	locale
苏家屯站	locale
根河站	locale
沙河市站	locale
威岭站	locale
红安西站	locale
延津站	locale
松河站	locale
索伦站	locale
仙水站	locale
普雄站	locale
官字井站	locale
大武口站	locale
元山子站	locale
玉泉站	locale
李市镇站	locale
治山站	locale
温都和硕站	locale
古镇站	locale
冠豸山站	locale
三水南站	locale
和村站	locale
新沂站	locale
民族站	locale
高兴站	locale
麻山站	locale
会同站	locale
天义站	locale
刀尔登站	locale
分水寺站	locale
彬江站	locale
永城北站	locale
凉风垭站	locale
熊岳城站	locale
峨边站	locale
高家村站	locale
长寿站	locale
平邑站	locale
巢湖站	locale
横江站	locale
马头站	locale
彝良南站	locale
大田边站	locale
昆独仑召站	locale
罗盘地站	locale
双城北站	locale
春亭阁站	locale
乔子玄站	locale
亳州站	locale
江桥站	locale
大洋洲站	locale
六安站	locale
蔺市站	locale
古城站	locale
六合镇站	locale
白石山站	locale
兰州东站	locale
大雅河站	locale
邵阳北站	locale
大余站	locale
查干芒和站	locale
沙力站	locale
双牌站	locale
兴福站	locale
包头东站	locale
始兴站	locale
东海站	locale
晏城站	locale
义乌站	locale
阳邑站	locale
南宁东站	locale
老边站	locale
横店东站	locale
胪滨站	locale
亚沟站	locale
巴彦郭勒站	locale
大江口站	locale
乐东站	locale
厦门高崎站	locale
南杂木站	locale
偏岭站	locale
乌尔旗汗站	locale
偃师站	locale
简阳南站	locale
白银哈尔站	locale
贾鲁河站	locale
大庆西站	locale
西丽站	locale
全椒站	locale
小得江站	locale
新民站	locale
金马村站	locale
于都站	locale
霍邱站	locale
群力站	locale
广顺场站	locale
松江镇站	locale
达家沟站	locale
土贵乌拉站	locale
天柱山站	locale
吉水站	locale
南江站	locale
西乡站	locale
白涧站	locale
平等站	locale
镇安站	locale
廉江站	locale
滕州站	locale
栟茶站	locale
高各庄站	locale
攸县南站	locale
马蹄湾站	locale
魏杖子站	locale
白水江站	locale
营口东站	locale
隆安东站	locale
海宁站	locale
渭源站	locale
好鲁库站	locale
沈阳西站	locale
四分滩站	locale
涉县站	locale
龙丰站	locale
十字铺站	locale
农安站	locale
官家站	locale
肃宁站	locale
天水南站	locale
白河县站	locale
沂南站	locale
石滩站	locale
灵宝西站	locale
亭亮站	locale
贵阳东站	locale
通安驿站	locale
六道河站	locale
海城西站	locale
金华南站	locale
梨树镇站	locale
古固寨站	locale
莎车站	locale
甘家坝站	locale
金坑站	locale
高桥镇站	locale
燕家庄站	locale
平湖站	locale
盘锦北站	locale
库尔勒站	locale
三道营站	locale
大土站	locale
沈家站	locale
劳动屯站	locale
团结村站	locale
大足站	locale
福港站	locale
张百湾站	locale
泾川站	locale
利津南站	locale
商河站	locale
广通北站	locale
中兴站	locale
天桥岭站	locale
明光站	locale
大陵站	locale
北京站	locale
岭南站	locale
小西庄站	locale
宣城站	locale
兴隆县站	locale
松滋站	locale
尤溪站	locale
婺源站	locale
西小沟站	locale
大英东站	locale
海城站	locale
三道湖站	locale
上虞北站	locale
吴家屯站	locale
阿巴嘎旗站	locale
迎水桥站	locale
西枣林站	locale
三水站	locale
青龙场站	locale
金谷站	locale
那铺站	locale
杨树岭站	locale
新城子站	locale
乌兰胡同站	locale
豪门站	locale
齐齐哈尔南站	locale
天津西站	locale
周家站	locale
溶口站	locale
德州东站	locale
小北站	locale
汤山城站	locale
刘家河站	locale
茂名西站	locale
柞水站	locale
兴平站	locale
佟家站	locale
下夹河所站	locale
凤县站	locale
倒湖站	locale
桃映站	locale
溧阳站	locale
串子沟站	locale
闽清北站	locale
巴关岭站	locale
白泉站	locale
荆州站	locale
敖来站	locale
新都站	locale
孔家沟站	locale
桃儿湾站	locale
长沙埂站	locale
祁东站	locale
南山北站	locale
商丘站	locale
伊尔施站	locale
**********站	locale
乌拉特前旗站	locale
苍石站	locale
二道湾站	locale
开原西站	locale
向阳川站	locale
哈达铺站	locale
他石海站	locale
恩施站	locale
昆明东站	locale
狼尾山站	locale
泰达站	locale
湾沚站	locale
三元坝站	locale
达板城站	locale
笔架山站	locale
伊和恩格拉站	locale
党家庄站	locale
乌海西站	locale
石门县南站	locale
富源站	locale
嫩江站	locale
二道岩站	locale
应县站	locale
章党站	locale
宝林站	locale
凉红站	locale
毛陈站	locale
精河站	locale
石湖站	locale
墩义堂站	locale
芦潮港站	locale
革居站	locale
濮阳站	locale
瀼河站	locale
干塘站	locale
吴场站	locale
武夷山北站	locale
重庆南站	locale
东丰站	locale
二道桥站	locale
昂乃站	locale
湖州站	locale
莱西北站	locale
四马架站	locale
湖州南站	locale
都匀东站	locale
高坪铺站	locale
贺胜桥东站	locale
茨坝站	locale
草市站	locale
大庙站	locale
滦河沿站	locale
皮口站	locale
板城站	locale
武昌东站	locale
大苴站	locale
野马寨站	locale
横沟桥东站	locale
成都站	locale
铜鼓井站	locale
盐池站	locale
裕民站	locale
许家台站	locale
天水站	locale
桐乡站	locale
磁窑站	locale
红果站	locale
平泉站	locale
兰州站	locale
换新天站	locale
达日其嘎站	locale
镇平站	locale
舒兰站	locale
鸡西站	locale
鄂尔多斯站	locale
红土沟站	locale
宣和站	locale
刘家店站	locale
铁厂站	locale
新友谊站	locale
渠县站	locale
塔石嘴站	locale
武当山站	locale
官高站	locale
左岭站	locale
阎家站	locale
铅山西站	locale
安亭北站	locale
王瞳站	locale
前磨头站	locale
鸦雀岭站	locale
西哲里木站	locale
鄯善北站	locale
南河川站	locale
九郎山站	locale
大坝站	locale
五道沟站	locale
红光镇站	locale
美溪站	locale
青岛站	locale
祁阳北站	locale
月池台站	locale
禄市站	locale
索图罕站	locale
观阁站	locale
白旗站	locale
抚顺站	locale
四合站	locale
宁强站	locale
长安站	locale
龙泉寺站	locale
大溶江站	locale
麻柳镇站	locale
鹤立站	locale
碾庄站	locale
中宁站	locale
昭通北站	locale
鹤岗站	locale
中嘴站	locale
焦作东站	locale
莲东站	locale
陶辛站	locale
浠水站	locale
北磴站	locale
郑家堡站	locale
炎陵站	locale
五莲站	locale
宁明站	locale
思站	locale
垭口站	locale
道劳杜站	locale
诸城站	locale
大杨树东站	locale
六道河子站	locale
二龙山屯站	locale
黄康站	locale
郭家店站	locale
贺州站	locale
西哈站	locale
郫县站	locale
新郑机场站	locale
贵定站	locale
白沙坡站	locale
王家营站	locale
白银市站	locale
扎兰屯站	locale
内乡站	locale
清远站	locale
龙镇站	locale
临淄站	locale
颍上站	locale
秧草地站	locale
开通站	locale
怀柔北站	locale
黄联关站	locale
曹家营子站	locale
干溪沟站	locale
永康南站	locale
全州站	locale
温泉寺站	locale
枫林站	locale
湛江西站	locale
峡江站	locale
江源站	locale
兴安北站	locale
碧州站	locale
陶家沟站	locale
赛金桥站	locale
广州西站	locale
石沱站	locale
武义站	locale
东莞东站	locale
拉哈站	locale
宁德站	locale
七泉湖站	locale
福山镇站	locale
养马河站	locale
军垦站	locale
宋城路站	locale
玉石站	locale
玉舍站	locale
忽吉图站	locale
黄冈东站	locale
荣成站	locale
青花站	locale
白沙沱站	locale
五凤溪站	locale
永郎站	locale
八虎力站	locale
塔尔气站	locale
王安镇站	locale
上万站	locale
枣子林站	locale
那罗站	locale
华城站	locale
上饶站	locale
大米溪站	locale
瓦窑坝站	locale
程村站	locale
李河站	locale
**站	locale
哈拉沟站	locale
新松浦站	locale
鼎湖东站	locale
榆树台站	locale
郓城站	locale
营城子站	locale
猛鹫山站	locale
黄平站	locale
三平站	locale
苏坂站	locale
茂林站	locale
文阁站	locale
临泽站	locale
嘉祥站	locale
吴桥站	locale
余姚北站	locale
孤山子站	locale
大厂县站	locale
石人站	locale
东津站	locale
磁西站	locale
昌吉站	locale
阿拉山口站	locale
安图站	locale
白城站	locale
喜德站	locale
米沙子站	locale
呼家塔站	locale
白音他拉站	locale
向塘站	locale
大沙田站	locale
丹东西站	locale
长兴站	locale
胶州站	locale
飞来峡站	locale
泔溪站	locale
大德站	locale
白狼站	locale
溪洞站	locale
嵩明站	locale
内邱站	locale
顺德站	locale
倭肯站	locale
大林站	locale
徐屯站	locale
尼木站	locale
大罕站	locale
大灰厂站	locale
石门村站	locale
轵城站	locale
夏官营站	locale
郁山站	locale
阳春站	locale
闽清站	locale
杨陵南站	locale
沙塘站	locale
乐武站	locale
四平东站	locale
包头站	locale
遵义站	locale
旬阳站	locale
当雄站	locale
盖州站	locale
巴关河站	locale
夏家河站	locale
首山站	locale
东宫站	locale
佛山站	locale
哈密站	locale
富海站	locale
茄子溪站	locale
犀浦东站	locale
洛东站	locale
滩站	locale
老锅厂站	locale
曲靖站	locale
江市站	locale
汉王山站	locale
泉州站	locale
腊哈地站	locale
励家站	locale
岳阳站	locale
红花园站	locale
东水峡站	locale
日喀则站	locale
革志站	locale
月山站	locale
拉古站	locale
胜芳站	locale
淮安南站	locale
屏边站	locale
南洼站	locale
泽润里站	locale
五大连池站	locale
平峪站	locale
大官屯站	locale
浪河站	locale
北岗站	locale
巴日图站	locale
五龙背站	locale
五龙背东站	locale
前窑站	locale
天祝站	locale
集宁南站	locale
叉车厂站	locale
汤阴站	locale
林西站	locale
宁乡站	locale
梨子山站	locale
独山站	locale
太阳山站	locale
田心东站	locale
坦甸站	locale
哈日努拉站	locale
肇东站	locale
泰山站	locale
南塘镇站	locale
韩府湾站	locale
洛阳龙门站	locale
昆山南站	locale
满归站	locale
庙宫站	locale
带岭站	locale
八义集站	locale
高峰站	locale
双流机场站	locale
龙潭寺站	locale
梁平南站	locale
东门站	locale
树舍站	locale
孟庄站	locale
塔尔根站	locale
包庄站	locale
金刚沱站	locale
哲里木站	locale
明珠站	locale
星朗站	locale
东安东站	locale
柴沟堡站	locale
石岭站	locale
安家站	locale
梧州南站	locale
柳州站	locale
大石桥站	locale
吴家川站	locale
关村坝站	locale
哈尔盖站	locale
龙爪沟站	locale
海林站	locale
温州站	locale
北海站	locale
长武站	locale
尚志站	locale
包头西站	locale
界首市站	locale
永修站	locale
邓家湾站	locale
合阳北站	locale
礼泉站	locale
公积坂站	locale
百里村站	locale
夏石站	locale
荣昌北站	locale
黎塘站	locale
双吉站	locale
嘉川站	locale
黄瓜园站	locale
天河机场站	locale
临邑站	locale
晋江站	locale
归德乡站	locale
白涛站	locale
高楼房站	locale
擦耳站	locale
乐都站	locale
攸县站	locale
树林站	locale
宏图站	locale
陶赖昭站	locale
绥阳站	locale
宝龙山站	locale
共青城站	locale
葛店南站	locale
爱河站	locale
白塔站	locale
营山站	locale
铜佛寺站	locale
刚察站	locale
芙蓉南站	locale
洪河站	locale
潮阳站	locale
奎屯站	locale
柳树站	locale
亮兵台站	locale
松树镇站	locale
兴无站	locale
徘徊北站	locale
红峰站	locale
四方站	locale
天西站	locale
临溪站	locale
绕阳河站	locale
绥芬河站	locale
沃皮站	locale
青岭子站	locale
延吉西站	locale
大塔站	locale
锦河站	locale
治安站	locale
上腰墩站	locale
获鹿所站	locale
皇德站	locale
柳毛站	locale
旺苍站	locale
嘉善南站	locale
姜堰站	locale
钟山站	locale
青杠站	locale
临江场站	locale
紫沟站	locale
罗平站	locale
白马站	locale
迎宾路站	locale
化处站	locale
章丘站	locale
长兴南站	locale
朱嘎站	locale
长冲站	locale
小浩站	locale
广州站	locale
庙庄站	locale
泡子站	locale
哈拉苏站	locale
麻尾站	locale
煤田站	locale
新平坝站	locale
通远堡站	locale
合肥西站	locale
南大庙站	locale
松青站	locale
昌平北站	locale
秀山站	locale
白鸡坡站	locale
嘎什甸子站	locale
西昌南站	locale
杨柳街站	locale
重庆西站	locale
石家砭站	locale
甲山站	locale
东港北站	locale
旬阳北站	locale
崇信站	locale
温泉站	locale
青堆站	locale
横道河子站	locale
黑井站	locale
钟祥站	locale
无锡新区站	locale
祁家堡站	locale
麻芝铺站	locale
襄阳东站	locale
马嘎站	locale
四平站	locale
鸡公山站	locale
白银西站	locale
赶水站	locale
普家村所站	locale
五叉沟站	locale
白芨沟站	locale
范家屯站	locale
开安站	locale
老府站	locale
吕城站	locale
上河清站	locale
渔坝村站	locale
下坑子站	locale
富县站	locale
磐石站	locale
扎泥河站	locale
石林站	locale
武夷山站	locale
龙门南站	locale
余江站	locale
长胜沟站	locale
缯溪河站	locale
巩义站	locale
春申站	locale
卧牛河站	locale
北马圈子站	locale
炮车站	locale
长汀南站	locale
大坪站	locale
青白江东站	locale
大昌站	locale
玛纳斯湖站	locale
哈克站	locale
垫江站	locale
兴城站	locale
高滩站	locale
三义井站	locale
通辽北站	locale
查干特格站	locale
金州站	locale
沙桥站	locale
红星站	locale
饮马峡站	locale
古里金站	locale
陇西站	locale
东明县站	locale
宁国站	locale
田林站	locale
汐子站	locale
三营站	locale
沈阳站	locale
宝坻站	locale
淇县站	locale
临颍站	locale
红江站	locale
姚家站	locale
双福站	locale
站	locale
六盘水站	locale
乌固诺尔站	locale
高台子站	locale
渭南南站	locale
凌海站	locale
金银潭站	locale
鸽子洞站	locale
泉沟站	locale
黄家营站	locale
通海站	locale
通化站	locale
福鼎站	locale
邢台东站	locale
石马坝站	locale
三汇镇站	locale
沈阳南站	locale
西安站	locale
丰城站	locale
龙伯屯站	locale
惠农站	locale
叶柏寿站	locale
嘉峪关南站	locale
莲花山站	locale
花湖站	locale
英德西站	locale
抚松站	locale
赣州站	locale
丰台西站	locale
山河屯站	locale
峨眉站	locale
麻柳站	locale
铁力站	locale
凤城东站	locale
大深站	locale
港口镇站	locale
廊坊站	locale
亚龙湾站	locale
猛洞河站	locale
南湖东站	locale
黄甲屯站	locale
沧州站	locale
小南垭站	locale
咸阳秦都站	locale
德伯斯站	locale
商丘南站	locale
酒泉南站	locale
巴东站	locale
樟木头东站	locale
宜城站	locale
一平浪站	locale
大理北站	locale
长垣站	locale
冕山站	locale
新开站	locale
祁东北站	locale
杨木站	locale
青铜峡站	locale
义县站	locale
大用站	locale
银镇站	locale
弋阳站	locale
元田坝站	locale
纪家沟站	locale
田独站	locale
嘉兴南站	locale
构林站	locale
广元东站	locale
绥西站	locale
上寺站	locale
双石桥站	locale
大冶北站	locale
罗江东站	locale
帽儿山站	locale
亚河站	locale
涿州站	locale
宝泉岭站	locale
保家楼站	locale
开封北站	locale
元坝站	locale
蓬安站	locale
砀山南站	locale
新化站	locale
上板城站	locale
龙井村站	locale
安平站	locale
楚雄南站	locale
南汤站	locale
石景山南站	locale
徐州东站	locale
马角坝站	locale
涧池铺站	locale
草海站	locale
龙家营站	locale
阜阳站	locale
中牟站	locale
南华站	locale
九台站	locale
仙林站	locale
石嘴山站	locale
宜良北站	locale
建北站	locale
甲路站	locale
向阳站	locale
天回镇站	locale
庐山站	locale
东富站	locale
松树台站	locale
望江站	locale
鸡冠山站	locale
瓢儿屯站	locale
黄丝站	locale
柳树泉站	locale
砀山站	locale
扬州站	locale
南岔站	locale
先锋站	locale
董庄站	locale
苏州新区站	locale
古城子站	locale
顺义站	locale
兴莲站	locale
苏集站	locale
南平北站	locale
杭州东站	locale
洪家嘴站	locale
露水河站	locale
鲅鱼圈站	locale
舍力虎站	locale
东二道河站	locale
长岭子站	locale
镇赉站	locale
博白站	locale
甘旗卡站	locale
奔牛站	locale
照福铺站	locale
长虹站	locale
新坡站	locale
卧里屯站	locale
金宝屯站	locale
和平站	locale
万州北站	locale
乌鲁木齐站	locale
西沟站	locale
武功站	locale
西八里站	locale
金城江站	locale
临沂站	locale
江边村站	locale
娄底南站	locale
阿乌尼站	locale
沾益站	locale
句容西站	locale
坞坭站	locale
琥市站	locale
贵定县站	locale
中和站	locale
惠环站	locale
小村站	locale
绵阳站	locale
宏庆站	locale
崖州站	locale
海北站	locale
江宁西站	locale
官渡站	locale
宝华山站	locale
平果站	locale
学庄站	locale
二营子站	locale
福泉站	locale
双流站	locale
通天屯站	locale
普者黑站	locale
岳池站	locale
樟木头站	locale
棠海站	locale
昌平站	locale
马林站	locale
蒲坝站	locale
改貌站	locale
茶淀站	locale
通远堡西站	locale
双流西站	locale
天门南站	locale
紫溪站	locale
城固站	locale
九燕山站	locale
谢家站	locale
塔石咀站	locale
喀什站	locale
卡路屯站	locale
燕子砭站	locale
小东站	locale
咸阳站	locale
洛阳站	locale
三穗站	locale
横现河站	locale
英额门站	locale
塘雅站	locale
进贤站	locale
漯河西站	locale
劲松站	locale
王场站	locale
四分地站	locale
蛟河西站	locale
德惠站	locale
红柳河站	locale
继承站	locale
雁翅站	locale
新青站	locale
辉河站	locale
白沟站	locale
广元站	locale
黄集站	locale
师庄站	locale
凌源站	locale
任丘站	locale
枝江站	locale
南博山站	locale
小雨谷站	locale
上仓站	locale
肇庆站	locale
木镇站	locale
大松树站	locale
庄河北站	locale
厦门北站	locale
兴隆山站	locale
沥林北站	locale
沂水站	locale
营盘上站	locale
谭庄站	locale
柳毛沟站	locale
海安县站	locale
黄家店站	locale
卫星站	locale
咸宁站	locale
新李站	locale
枝城站	locale
弯集站	locale
郭尔奔敖包站	locale
南城站	locale
水花站	locale
芦家村站	locale
七龙星站	locale
平南南站	locale
罗妙真站	locale
望溪站	locale
威箐站	locale
涪陵站	locale
深圳西站	locale
长寿湖站	locale
红岘台站	locale
重庆北站	locale
台安站	locale
读书铺站	locale
鹤壁东站	locale
盖州西站	locale
高家站	locale
南关岭站	locale
长城站	locale
桂林西站	locale
丹阳北站	locale
吴圩站	locale
文畈站	locale
虢镇站	locale
邢家堡站	locale
宜州站	locale
双龙站	locale
大杨树站	locale
广州南站	locale
靖州站	locale
沾河站	locale
赣州东站	locale
阿贵图站	locale
曲阜东站	locale
立志站	locale
南京站	locale
孙家站	locale
马鞍岭站	locale
汉阴站	locale
德惠西站	locale
孔垄站	locale
铜仁站	locale
鲁番站	locale
南湾子站	locale
街基站	locale
开原站	locale
花果站	locale
抚州北站	locale
辽阳站	locale
大保当站	locale
河口北站	locale
尼勒克站	locale
三井子站	locale
杨各庄站	locale
符离集站	locale
石脑站	locale
靖远西站	locale
洛社站	locale
红旗营站	locale
大杖子站	locale
西宁西站	locale
犀浦站	locale
吕河站	locale
蓟县南站	locale
北滘站	locale
七苏木站	locale
南曹站	locale
孝感站	locale
邯郸站	locale
高兴镇站	locale
庙阳站	locale
蒲山店站	locale
上海西站	locale
思甜站	locale
鹤北站	locale
新寒岭站	locale
琅琊站	locale
岔江站	locale
新高峰站	locale
北京东站	locale
岩山站	locale
六盘山站	locale
大丰站	locale
榕江站	locale
江口集站	locale
王家坝站	locale
洛门站	locale
四道湾站	locale
玉门镇站	locale
讷河站	locale
明水河站	locale
开江站	locale
古家沱站	locale
三江口站	locale
南昌站	locale
惠州站	locale
安庆站	locale
庆丰站	locale
鞍山西站	locale
涪陵北站	locale
葵潭站	locale
桓台站	locale
双峰北站	locale
巨野站	locale
弄弄坪站	locale
锦和站	locale
正定站	locale
康熙岭站	locale
马村站	locale
双望站	locale
饶平站	locale
靖边站	locale
丰台站	locale
巨亭站	locale
都江堰站	locale
仙桃西站	locale
乌鲁木齐南站	locale
丽水站	locale
秦岭站	locale
榆树川站	locale
凯里西站	locale
沙坝站	locale
芝罘站	locale
二道河站	locale
奈曼站	locale
大屯站	locale
克东站	locale
马铺营站	locale
凉水井站	locale
苍坪站	locale
山城镇站	locale
湾边站	locale
昆都仑召站	locale
刘家村站	locale
彝良站	locale
山海关站	locale
拉林站	locale
枣庄西站	locale
茶陵南站	locale
刘集站	locale
巢北站	locale
太白站	locale
黑冲滩站	locale
张家川站	locale
江宁站	locale
氡泉站	locale
新窑站	locale
夏拉哈马站	locale
任家店站	locale
昆明南站	locale
虎什哈站	locale
德令哈站	locale
阜南站	locale
六甲站	locale
西安北站	locale
马龙站	locale
上普雄站	locale
沙县站	locale
龙市站	locale
龙亭站	locale
复盛站	locale
册亨站	locale
泗阳站	locale
漳浦站	locale
铜鼓溪站	locale
潍坊站	locale
常平站	locale
平山站	locale
沙坨子站	locale
新桥站	locale
永福南站	locale
杨家营站	locale
固安站	locale
景德镇站	locale
勤丰营站	locale
金寨站	locale
瓜州站	locale
蓟县站	locale
乐昌东站	locale
赤壁站	locale
小黑山站	locale
杨村站	locale
庄河站	locale
牛栏山站	locale
茂舍祖站	locale
小河沿站	locale
乌伊岭站	locale
图里河站	locale
济南西站	locale
三道桥站	locale
大河桥站	locale
黄水塘站	locale
拉法站	locale
沙沱站	locale
狮山站	locale
辽中站	locale
水曲柳站	locale
伊林站	locale
綦江站	locale
梅江站	locale
白河站	locale
半边街站	locale
平房站	locale
九营站	locale
托托站	locale
孔滩站	locale
六里坪站	locale
驼腰岭站	locale
营街站	locale
东京城站	locale
略阳站	locale
史家铺站	locale
三亚站	locale
代湾站	locale
姑家堡站	locale
张家界北站	locale
共和站	locale
槐荫站	locale
黄泥崴子站	locale
灵宝站	locale
乐平市站	locale
沙后所站	locale
郭家营站	locale
镇远站	locale
铜陵站	locale
民和站	locale
小哨站	locale
湟源站	locale
明阳站	locale
白石岩站	locale
丹凤站	locale
平罗站	locale
卫东站	locale
汨罗东站	locale
水地站	locale
东升坝站	locale
桦皮厂站	locale
苏家坡站	locale
沙琅站	locale
滦县东站	locale
兰州西站	locale
石门县站	locale
唐山北站	locale
北安站	locale
石门子站	locale
封丘站	locale
那玉站	locale
珠斯花站	locale
福利屯站	locale
宜昌站	locale
青县站	locale
杨陵站	locale
三十里铺站	locale
蒲城站	locale
阳朔站	locale
来福站	locale
渑池站	locale
陆川站	locale
虎石台站	locale
南口站	locale
土地堂东站	locale
柏果站	locale
巡场站	locale
裕国站	locale
巴林站	locale
洛湾三江站	locale
黄冈站	locale
芜湖站	locale
福山口站	locale
灌水站	locale
金月湾站	locale
枫泾站	locale
疏勒河站	locale
牛头山站	locale
峰高铺站	locale
一步滩站	locale
到保站	locale
洞井站	locale
长山屯站	locale
秋木庄站	locale
浩良河站	locale
崇仁站	locale
高炉子站	locale
大竹园站	locale
卓资东站	locale
乌斯土站	locale
杨家店站	locale
临江站	locale
三花石站	locale
苏州站	locale
潮汕站	locale
普宁站	locale
新华庄站	locale
成吉思汗站	locale
周水子站	locale
上海南站	locale
萧县北站	locale
南芬站	locale
张家堡站	locale
小榄站	locale
黄州站	locale
文登站	locale
昭化站	locale
当涂东站	locale
桐子林站	locale
北林站	locale
东南营子站	locale
葡萄菁站	locale
九里山站	locale
新香坊站	locale
泉江站	locale
石人城站	locale
野三坡站	locale
杨家站	locale
应城站	locale
东营南站	locale
天津站	locale
安陆站	locale
甘泉站	locale
北京南站	locale
江西村站	locale
花山站	locale
龙南站	locale
缙云站	locale
陈家湖站	locale
镜铁山站	locale
华安站	locale
密马龙站	locale
上板城南站	locale
施秉站	locale
雅河站	locale
青白江站	locale
岳阳北站	locale
王团庄站	locale
葫芦岛站	locale
德胜站	locale
乔村站	locale
岑溪站	locale
曹子里站	locale
嵯岗站	locale
徐闻站	locale
鹤庆站	locale
大营镇站	locale
东莞站	locale
互助站	locale
酒泉站	locale
六合站	locale
双城堡站	locale
黔城站	locale
榆中站	locale
门源站	locale
吴官田站	locale
八方站	locale
黄石站	locale
迎祥街站	locale
铜罐驿站	locale
井陉站	locale
榆树屯站	locale
金鸡村站	locale
转关口站	locale
建安站	locale
霞浦站	locale
云山站	locale
羊场站	locale
蓝村站	locale
小山站	locale
官厅西站	locale
山丹站	locale
建阳站	locale
珠窝站	locale
惠州南站	locale
凤州站	locale
军山站	locale
迎春站	locale
顺河场站	locale
苦李井站	locale
咸宁东站	locale
西岗子站	locale
黄村站	locale
太姥山站	locale
潭岗站	locale
玉林站	locale
上关站	locale
土们岭站	locale
武威站	locale
豆庄站	locale
苏州北站	locale
容桂站	locale
即墨北站	locale
小溪坝站	locale
泾县站	locale
阳岔站	locale
阿里河站	locale
乐素河站	locale
五营站	locale
夏邑县站	locale
辛庄子站	locale
乌海站	locale
襄阳站	locale
六枝站	locale
青羊湾站	locale
柳园南站	locale
滨江站	locale
宁陵县站	locale
八仙筒站	locale
临沂北站	locale
黄梅站	locale
苏州园区站	locale
威海北站	locale
华家站	locale
泸阳站	locale
广南卫站	locale
火烧寨站	locale
临江溪站	locale
壮志站	locale
盘古寺站	locale
新场站	locale
镇紫街站	locale
博克图站	locale
南口前站	locale
钦州东站	locale
四家子站	locale
大巴站	locale
兴宁站	locale
定西站	locale
马柳站	locale
百里峡站	locale
石山站	locale
凯里站	locale
都伦站	locale
水家湖站	locale
桐城站	locale
羊草站	locale
赛汗塔拉站	locale
梁家渡站	locale
鲁河站	locale
晨明站	locale
敦煌站	locale
泗洪站	locale
阿寨站	locale
桥南站	locale
安顺西站	locale
大庆站	locale
九龙山站	locale
新安县站	locale
尾亚站	locale
陈家湾站	locale
谷城站	locale
牧原站	locale
花土坡站	locale
磁山站	locale
福兴地站	locale
长沙坝站	locale
青沟子站	locale
小岭站	locale
关岭站	locale
大连站	locale
布列开站	locale
后寨站	locale
沙坪坝站	locale
和硕站	locale
大板站	locale
河间西站	locale
斗沟子站	locale
观音阁站	locale
新城川站	locale
密云站	locale
白沙铺站	locale
长农站	locale
郑州东站	locale
民乐站	locale
***站	locale
渠黎站	locale
潜江站	locale
隆安站	locale
曲江站	locale
三江镇站	locale
下坡处站	locale
高山子站	locale
桂林北站	locale
玉门站	locale
何三家站	locale
鱼嘴站	locale
五家站	locale
吉祥峰站	locale
峙滩站	locale
汇南站	locale
临汝镇站	locale
蛟河站	locale
牙拉盖图站	locale
八达岭站	locale
安庆沟站	locale
泉阳站	locale
枣强站	locale
彬县站	locale
刘家沟站	locale
霸州西站	locale
百浪站	locale
桓龙湖站	locale
戎庄站	locale
南桥站	locale
四会站	locale
驻马店站	locale
惠东站	locale
高州站	locale
郜营站	locale
栋青树站	locale
胡家营站	locale
上高镇站	locale
铁岭站	locale
道清站	locale
满村站	locale
重庆站	locale
赤峰西站	locale
广汉北站	locale
厦门站	locale
潮水站	locale
东湾站	locale
谢家镇站	locale
清泰坡站	locale
豆张庄站	locale
三门县站	locale
上石站	locale
新泉站	locale
麻城北站	locale
迤资站	locale
长潭沟站	locale
龙江站	locale
杨岗站	locale
福巨站	locale
福山寺站	locale
通途站	locale
桃园站	locale
五常站	locale
花楼坝站	locale
肇庆东站	locale
公庙子站	locale
新立屯站	locale
佛山西站	locale
柴河站	locale
包头北站	locale
清风店站	locale
新民桥站	locale
成高子站	locale
定兴站	locale
洪安乡站	locale
商都站	locale
花山南站	locale
巩义南站	locale
青龙桥站	locale
秋梨沟站	locale
金山湾站	locale
王兆屯站	locale
绍兴北站	locale
静海站	locale
南雄站	locale
大成站	locale
武安站	locale
河站	locale
毛坝关站	locale
阿金站	locale
上杭站	locale
八都站	locale
富裕站	locale
伊敏站	locale
知字井站	locale
江门站	locale
潼南站	locale
西阳岔站	locale
大水站	locale
中卫站	locale
蜀河站	locale
朝天南站	locale
刘屯站	locale
蚌埠站	locale
建湖站	locale
台州站	locale
龙船站	locale
谷陇站	locale
七里河站	locale
南康站	locale
小高站	locale
斑竹园站	locale
张辛站	locale
普湾站	locale
三队站	locale
揭阳站	locale
唐家沱站	locale
渭南站	locale
白海站	locale
韶关东站	locale
龙池站	locale
神州站	locale
清河站	locale
湘乡站	locale
庄桥站	locale
弋阳东站	locale
石河子站	locale
别山站	locale
新肇站	locale
石崖寨站	locale
滥坝站	locale
成都东站	locale
柯坪站	locale
武夷山东站	locale
长汀镇站	locale
佛岭站	locale
镇西站	locale
龙口站	locale
谭家井站	locale
上谷站	locale
黄羊湾站	locale
汕尾站	locale
龙岩站	locale
郑州站	locale
漳州站	locale
老河口东站	locale
新彦站	locale
阿达日格站	locale
旌德站	locale
伊宁站	locale
广兴站	locale
迤那站	locale
龙里北站	locale
星耀站	locale
伊列克得站	locale
三界站	locale
太岭站	locale
合浦站	locale
安图西站	locale
南充东站	locale
泰宁站	locale
穰东站	locale
西街口站	locale
何刘站	locale
敬梓场站	locale
云霄站	locale
二营站	locale
霞洞站	locale
和什托洛盖站	locale
长春南站	locale
光明站	locale
三关口站	locale
奎山站	locale
攀枝花站	locale
道仑郭勒站	locale
公主岭站	locale
大理站	locale
铜仁南站	locale
乐居站	locale
双鸭山站	locale
舒城站	locale
大田山站	locale
绩溪县站	locale
六地沟站	locale
吉安站	locale
南台站	locale
前山站	locale
白马井站	locale
双柳站	locale
田庄镇站	locale
杨漩站	locale
团山站	locale
顺德学院站	locale
海坨子站	locale
美岱召站	locale
大陆号站	locale
海阳站	locale
荷马岭站	locale
德兴站	locale
宣汉站	locale
化州站	locale
灵武站	locale
天峻站	locale
珠海站	locale
******站	locale
彭山站	locale
*****站	locale
荷塘站	locale
萍乡站	locale
东大坝站	locale
滁州站	locale
天河街站	locale
南陵站	locale
东戌站	locale
长征站	locale
石柱槽站	locale
吉首站	locale
贵溪站	locale
水沟站	locale
羊圈子站	locale
深圳站	locale
铜陵东站	locale
武威南站	locale
乌拉山站	locale
超梁沟站	locale
施家嘴站	locale
宽甸站	locale
渭津站	locale
常德站	locale
博兴站	locale
北兴安站	locale
狮子营站	locale
西柳站	locale
罗坊站	locale
两河口站	locale
狮山北站	locale
棋子湾站	locale
香樟路站	locale
梅州站	locale
碧江站	locale
昌图站	locale
临湘站	locale
北屯镇站	locale
阿南庄站	locale
明安站	locale
马田墟站	locale
北头河站	locale
宁海站	locale
安达站	locale
禄丰站	locale
清平站	locale
××××站	locale
敖头站	locale
千阳站	locale
双河镇站	locale
许家屯站	locale
板塘站	locale
朱家沟站	locale
梧州站	locale
钱家店站	locale
清水县站	locale
通县西站	locale
五道河站	locale
桃山站	locale
余姚站	locale
株洲南站	locale
安顺站	locale
羊臼河站	locale
冯家坝站	locale
对青山站	locale
魏家沟站	locale
边沟站	locale
平凉南站	locale
杨陵镇站	locale
西斋站	locale
江密峰站	locale
永昌站	locale
张家船站	locale
明港东站	locale
葆园站	locale
新帐房站	locale
田阳站	locale
塔源站	locale
温春站	locale
博鳌站	locale
溧水站	locale
李家河站	locale
黄冈西站	locale
七台河站	locale
双泡子站	locale
五林站	locale
旗下营站	locale
庐江站	locale
老哈河站	locale
古鲁满汗站	locale
金山园区站	locale
沧口站	locale
南召站	locale
确山站	locale
沿河城站	locale
伊图里河站	locale
偏店站	locale
滕州东站	locale
永川站	locale
喜鹊乐站	locale
高阳镇站	locale
元宝山站	locale
龙家堡站	locale
原林站	locale
江门东站	locale
周家屯站	locale
三汇坝站	locale
瓦房店西站	locale
硕放站	locale
天湖站	locale
南阳站	locale
屯升站	locale
张家口站	locale
马盖图站	locale
凤凰站	locale
枣庄东站	locale
张掖站	locale
大禾塘站	locale
朝阳地站	locale
乃林站	locale
美兰站	locale
平顶山西站	locale
北流站	locale
园墩站	locale
银川南站	locale
乐昌站	locale
棕溪站	locale
清涧县站	locale
磨心坡站	locale
枣阳站	locale
创业村站	locale
塘库站	locale
容县站	locale
平河口站	locale
怀集站	locale
濑湍站	locale
东安站	locale
恒地营站	locale
元龙站	locale
五华山站	locale
忠工屯站	locale
大旺站	locale
沙马拉达站	locale
泗县站	locale
伊春站	locale
松江南站	locale
泰来站	locale
永和站	locale
余粮堡站	locale
上海虹桥站	locale
古田北站	locale
石峡子站	locale
沙河口站	locale
五女山站	locale
集安站	locale
宣威站	locale
宁波东站	locale
田坝站	locale
如皋站	locale
河洛营站	locale
鸡东站	locale
横岗站	locale
长寿北站	locale
三塘铺站	locale
南靖站	locale
平度站	locale
范镇站	locale
万州站	locale
海拉尔站	locale
西湾堡站	locale
四老沟站	locale
小关溪站	locale
刁家段站	locale
崔黄口站	locale
归流河站	locale
柳家庄站	locale
清水沟站	locale
金杖子站	locale
富林站	locale
雅鲁站	locale
朝阳站	locale
西南杖子站	locale
来宾站	locale
军粮城北站	locale
莒南站	locale
里腊站	locale
东壕站	locale
柏村站	locale
青龙寺站	locale
富源北站	locale
鹰潭北站	locale
蓟州站	locale
尖峰站	locale
坪上站	locale
青州市站	locale
汉中站	locale
大冶站	locale
慈城站	locale
兴和站	locale
门达站	locale
京山站	locale
郁南站	locale
马鞍山站	locale
运粮河站	locale
羊木站	locale
大王滩站	locale
吐哈站	locale
扎罗木得站	locale
南江口站	locale
银瓶站	locale
内江北站	locale
永泰站	locale
哈玛站	locale
六个鸡站	locale
杭锦旗站	locale
兰岭站	locale
安定站	locale
咋子站	locale
南芬北站	locale
淮安站	locale
绍兴东站	locale
焉耆站	locale
韶山南站	locale
暮云站	locale
太平川站	locale
杏树屯站	locale
朱坡站	locale
莱芜西站	locale
东营子站	locale
卓山站	locale
武昌南站	locale
安德站	locale
金河站	locale
车转湾站	locale
武义北站	locale
铁口站	locale
翠岗站	locale
广汉站	locale
明城站	locale
太平庄站	locale
阳谷站	locale
西斗铺站	locale
金山卫站	locale
敖力布告站	locale
九龙塘站	locale
二密河站	locale
塔崖驿站	locale
井店站	locale
罗源站	locale
蒲城东站	locale
竹园坝站	locale
坡底下站	locale
林盛堡站	locale
盘古站	locale
筹洞站	locale
瓦窑堡站	locale
孟溪站	locale
涪陵西站	locale
桐木寨站	locale
小白站	locale
瑞昌站	locale
信阳站	locale
米脂站	locale
乐跃站	locale
漳州东站	locale
黑龙堰站	locale
丙谷站	locale
公营子站	locale
渤海站	locale
梅陇站	locale
登瀛崖站	locale
牛坪子站	locale
富庄子站	locale
张巷站	locale
章古台站	locale
石城站	locale
承德站	locale
抚顺城站	locale
旗下营东站	locale
朝阳村站	locale
廉桥站	locale
乐善村站	locale
漠河站	locale
本溪站	locale
盘州站	locale
上店站	locale
早阳站	locale
梅河口站	locale
滦平站	locale
刁河店站	locale
迁安站	locale
珠海北站	locale
海晏站	locale
凤凰山站	locale
兴义站	locale
栏杆滩站	locale
安北站	locale
甘洛站	locale
苍溪站	locale
林源站	locale
赫尔洪得站	locale
东来站	locale
临江寺站	locale
鄯善站	locale
华蓥站	locale
巴彦高勒站	locale
珲春站	locale
上营站	locale
广元南站	locale
新站站	locale
通沟站	locale
平台站	locale
抚顺北站	locale
夏坝站	locale
丙午站	locale
鹰潭站	locale
杨杖子站	locale
龙川站	locale
光明城站	locale
扶余站	locale
汤逊湖站	locale
娘娘庙站	locale
五原站	locale
信宜站	locale
古城湾站	locale
霍尔果斯站	locale
大兴沟站	locale
日照站	locale
友好站	locale
高要站	locale
棋盘站	locale
黑河站	locale
南溪沟站	locale
沈阳北站	locale
牛家站	locale
老堡站	locale
麻栗站	locale
周村站	locale
南张村站	locale
黄陵站	locale
全州南站	locale
鱼卡站	locale
格尔木站	locale
南通站	locale
七眼桥站	locale
新郑站	locale
扶余北站	locale
大平房站	locale
阜新南站	locale
谭家坝站	locale
白音胡硕站	locale
渠旧站	locale
中小所站	locale
娄山关站	locale
瓦屋山站	locale
二岔站	locale
小花果站	locale
玛纳斯站	locale
孟家岗站	locale
鄄城站	locale
马皇站	locale
广德号站	locale
新保安站	locale
乌兰哈达站	locale
八角台站	locale
佛峪站	locale
梁平站	locale
金钟站	locale
云居寺站	locale
石桥镇站	locale
坡底村站	locale
杨柳青站	locale
抚州站	locale
新丰镇站	locale
大柴旦站	locale
完县站	locale
凭祥站	locale
老营站	locale
大方南站	locale
牧羊村站	locale
大垌站	locale
三把火站	locale
百宜站	locale
渡市站	locale
无为站	locale
河汤沟站	locale
小唐庄站	locale
子长站	locale
峨眉山站	locale
泊头站	locale
隆化站	locale
王家营西站	locale
泉水站	locale
全胜站	locale
墙子路站	locale
横峰站	locale
礼州站	locale
将军河站	locale
平坝站	locale
白水镇站	locale
平坊站	locale
襄樊站	locale
洛阳北站	locale
三十家站	locale
永乐店站	locale
****站	locale
漠河县站	locale
零陵站	locale
艾家村站	locale
功塘站	locale
大拟站	locale
瓦祖站	locale
大连北站	locale
碧鸡关站	locale
金字牌站	locale
台前站	locale
沛屯站	locale
石家庄站	locale
三堆子站	locale
上园站	locale
云东海站	locale
翠峰站	locale
阿城站	locale
民和南站	locale
太平店站	locale
朝格温多尔站	locale
西麻山站	locale
景泰站	locale
哈达阳站	locale
丰城南站	locale
纳雍站	locale
霸州站	locale
青城山站	locale
西索木站	locale
冯屯站	locale
襄汾西站	locale
张集站	locale
塘头厦站	locale
八家子站	locale
古浪站	locale
青堆子站	locale
昭山站	locale
侯家坪站	locale
中滩站	locale
信阳东站	locale
沙溪坝站	locale
龙田站	locale
白音察干站	locale
车岗站	locale
坪石站	locale
邵家堂站	locale
马回岭站	locale
窑上站	locale
牙克石站	locale
宜耐站	locale
杜拉尔站	locale
沙城站	locale
白山乡站	locale
孔家庄站	locale
乌西站	locale
双阳站	locale
皋兰站	locale
高台站	locale
嘉兴站	locale
康金井站	locale
打羊站	locale
香兰站	locale
古莲站	locale
宜昌东站	locale
白桦排站	locale
牙屯堡站	locale
淮滨站	locale
大徐屯站	locale
嘉善站	locale
白塔埠站	locale
大观岭站	locale
定陶站	locale
勉县站	locale
西永站	locale
轸溪站	locale
乾县站	locale
太平镇站	locale
东光站	locale
怀柔站	locale
建设站	locale
通辽站	locale
南平南站	locale
九标站	locale
八村站	locale
河阳站	locale
厚坝站	locale
罗江站	locale
九江站	locale
下峪口站	locale
三江南站	locale
蔺家楼站	locale
龙潭站	locale
耒阳站	locale
醪桥站	locale
松树坡站	locale
桥湾站	locale
大其拉哈站	locale
贵定北站	locale
西丰站	locale
宝木吐站	locale
藁城站	locale
白山市站	locale
芷江站	locale
遂平站	locale
东沟门站	locale
从江站	locale
虎山站	locale
三原站	locale
罗敷站	locale
丰都站	locale
郴州西站	locale
闹海营站	locale
振德站	locale
营口站	locale
自贡站	locale
河源站	locale
两所屯站	locale
平昌站	locale
达拉特旗站	locale
新固镇站	locale
伏牛溪站	locale
桥头集站	locale
弥渡站	locale
东海县站	locale
乌川站	locale
乌兰浩特站	locale
哈达站	locale
韶山站	locale
平原堡站	locale
建宁县北站	locale
青神站	locale
濉溪站	locale
旧庄窝站	locale
广德站	locale
大孤山站	locale
临西站	locale
石子坝站	locale
庙山站	locale
吉文站	locale
龙家营所站	locale
淮南站	locale
冠朝站	locale
沈阳东站	locale
十里坪站	locale
渭南镇站	locale
德清站	locale
姚千户屯站	locale
永定站	locale
金堂站	locale
华容东站	locale
四合永站	locale
仙游站	locale
大扬气站	locale
乌兰花站	locale
白鹿塘站	locale
太湖站	locale
草河口站	locale
蓬溪站	locale
南岸坝站	locale
威舍站	locale
呼兰站	locale
俞冲站	locale
龙游站	locale
海宁西站	locale
大理东站	locale
独立屯站	locale
叶集站	locale
鸳鸯镇站	locale
芦台站	locale
下塘集站	locale
白奎堡站	locale
新化南站	locale
牡丹江站	locale
黄石东站	locale
大岗站	locale
哈尔巴岭站	locale
丰乐镇站	locale
巨宝站	locale
弓棚子站	locale
康庄站	locale
落坡岭站	locale
树木岭站	locale
无锡东站	locale
长坡岭站	locale
衡水站	locale
钟杖子站	locale
益阳站	locale
亚布力站	locale
周口站	locale
深圳坪山站	locale
开鲁站	locale
三介海子站	locale
三阳川站	locale
曲靖北站	locale
西六方站	locale
马桥河站	locale
内江南站	locale
海口站	locale
金口河站	locale
永甸站	locale
柏林站	locale
宜兴站	locale
广通站	locale
梁家坝站	locale
工农湖站	locale
萧家村站	locale
泥河子站	locale
巴伦台站	locale
常平东站	locale
毛坝站	locale
额济纳站	locale
无锡站	locale
沧州西站	locale
朝天站	locale
昌黎站	locale
三河县站	locale
三岔站	locale
十家子站	locale
胶州北站	locale
海东西站	locale
么铺站	locale
宝鸡南站	locale
锡林呼都嘎站	locale
潢川站	locale
图呼木站	locale
祁门站	locale
新乡站	locale
通州西站	locale
青田站	locale
黑山站	locale
凌家场站	locale
鄂州站	locale
黄站	locale
一面坡站	locale
清水北站	locale
长葛站	locale
德仁站	locale
达拉特西站	locale
银川站	locale
津沪所站	locale
三明站	locale
讷尔克气站	locale
大通西站	locale
长基站	locale
英德站	locale
峰洞站	locale
三家子站	locale
平顶山站	locale
祥云站	locale
天津北站	locale
宁安站	locale
那曲站	locale
麻虎站	locale
江油站	locale
舍伯吐站	locale
安亭站	locale
打柴沟站	locale
防城站	locale
孟庙站	locale
沙湾站	locale
阿尔山站	locale
仙村站	locale
道德站	locale
陇县站	locale
广南县站	locale
万庄站	locale
徐塘庄站	locale
山阴站	locale
低窝铺站	locale
汨罗站	locale
瓦房店站	locale
井南站	locale
南昌西站	locale
龙沟站	locale
石郎庄站	locale
皮山站	locale
得胜台站	locale
八苏木站	locale
昭通南站	locale
鸭园站	locale
长河坝站	locale
滨州站	locale
石燕桥站	locale
鱼泉站	locale
黄流站	locale
金山屯站	locale
潮州站	locale
武汉北站	locale
牛汾台站	locale
吉林西站	locale
密地站	locale
双子河站	locale
汤旺河站	locale
尼波站	locale
保康站	locale
花棚子站	locale
陵丘站	locale
精河南站	locale
乐化站	locale
福临堡站	locale
大安站	locale
老爷岭站	locale
喀喇其站	locale
牛叫河站	locale
仲恺站	locale
仁寿村站	locale
松村站	locale
茶卡站	locale
茶陵站	locale
梅花山站	locale
旅顺站	locale
隆昌站	locale
白水站	locale
叶城站	locale
奇峰塔站	locale
太洪站	locale
桦南站	locale
合川站	locale
正镶白旗站	locale
杜家站	locale
济宁站	locale
莲塘站	locale
柯柯站	locale
沐滂站	locale
榆树站	locale
山湾子站	locale
靖西站	locale
际坑口站	locale
宁村站	locale
豆沙关站	locale
永州站	locale
下台子站	locale
埃岱站	locale
滨海站	locale
褚家湾站	locale
四方台站	locale
生芝渠站	locale
达县站	locale
徐水站	locale
加劳站	locale
惠安站	locale
木头营子站	locale
武汉站	locale
永宁镇站	locale
海石湾站	locale
柯坦站	locale
卡伦站	locale
玉山南站	locale
岷县站	locale
双凤驿站	locale
滩头站	locale
香坊站	locale
燕山站	locale
墟沟站	locale
蔡家坡站	locale
曹家坝站	locale
平安站	locale
神木站	locale
锦州站	locale
宝拉格站	locale
民权北站	locale
云浮东站	locale
吉舒站	locale
羊坪站	locale
义井站	locale
合肥北城站	locale
石花站	locale
吐鲁番站	locale
马兰站	locale
西胡尔清站	locale
曾家坪子站	locale
岳阳东站	locale
刘沟站	locale
湘潭北站	locale
鳌江站	locale
阿克苏站	locale
张桥站	locale
韩堂站	locale
东乡站	locale
庙头站	locale
上虞站	locale
荣昌站	locale
牛家营子站	locale
克利站	locale
统军庄站	locale
砚川站	locale
庙坝站	locale
北碚站	locale
南宫山站	locale
阜新站	locale
顺昌站	locale
古丈站	locale
二井站	locale
乌兰站	locale
织金站	locale
天津南站	locale
坦途站	locale
漳平站	locale
敖汉站	locale
福清站	locale
灵山站	locale
侯杖子站	locale
尔赛河站	locale
梅村站	locale
枝江北站	locale
通北站	locale
鲍峡站	locale
沙沙坡站	locale
草店站	locale
鹿寨北站	locale
华山北站	locale
菇园站	locale
板石河站	locale
中宁南站	locale
聊城站	locale
安化站	locale
瓦窑田站	locale
春风站	locale
北白站	locale
连珠山站	locale
嘉峪关站	locale
溆浦站	locale
赤峰站	locale
汗苏鲁站	locale
彭州站	locale
小董站	locale
林子头站	locale
郯城站	locale
松原北站	locale
哈密南站	locale
阳平关站	locale
清河门站	locale
畲江站	locale
宿州东站	locale
罗文站	locale
铁西站	locale
永川东站	locale
东岔站	locale
滁州北站	locale
绥化站	locale
当阳站	locale
阿尔山北站	locale
鲁山站	locale
洛阳东站	locale
高崎站	locale
大安北站	locale
驻马店西站	locale
长庆桥站	locale
项城站	locale
卢龙站	locale
桥头站	locale
兴安岭站	locale
三江县站	locale
张三营站	locale
伊拉哈站	locale
红安站	locale
太阳沟站	locale
城子坦站	locale
曲水站	locale
金华站	locale
阿克陶站	locale
安康站	locale
庆阳山站	locale
伊川站	locale
经久站	locale
依安站	locale
聂河站	locale
定州站	locale
大元站	locale
石林西站	locale
萧山站	locale
苔青站	locale
呈贡站	locale
葫芦岛北站	locale
龙骨甸站	locale
江北站	locale
二龙屯站	locale
红山站	locale
一间堡站	locale
大兴站	locale
捞刀河站	locale
安家湾站	locale
福州站	locale
涿州东站	locale
赤峰东站	locale
沙湾县站	locale
沙河站	locale
黑岗站	locale
茅草坪站	locale
阳信站	locale
高塘站	locale
黄土坡站	locale
让湖路站	locale
北台站	locale
三家寨站	locale
三营图站	locale
明水站	locale
资中北站	locale
德清西站	locale
林海站	locale
淮北站	locale
金华南所站	locale
曹县站	locale
湖南站	locale
鹤山站	locale
白音特拉站	locale
雨格站	locale
宝清站	locale
密山西站	locale
北屯站	locale
钟家村站	locale
融安站	locale
新阳镇站	locale
喇嘛山站	locale
菏泽站	locale
寒岭站	locale
喇嘛甸站	locale
邯郸东站	locale
油溪站	locale
汤头沟站	locale
北戴河站	locale
硬石岭站	locale
绥中站	locale
龙凤场站	locale
燕岗站	locale
图们站	locale
头道桥站	locale
留庄站	locale
南宁南站	locale
布吉站	locale
宝鸡站	locale
黄陵南站	locale
车墩站	locale
黄许镇站	locale
井头墟站	locale
林口站	locale
新安江站	locale
息县站	locale
西林站	locale
王楼站	locale
小喜村站	locale
八面通站	locale
平安镇站	locale
马莲河站	locale
大英站	locale
两家站	locale
算王庄站	locale
海湾站	locale
三间房站	locale
沈丘站	locale
榆林站	locale
苇子沟站	locale
楚山站	locale
郑家屯站	locale
黄家坝站	locale
金银川站	locale
贵阳北站	locale
衢州站	locale
化德站	locale
麻江站	locale
东方站	locale
三十里堡站	locale
北京北站	locale
汝箕沟站	locale
嘎什吐站	locale
松坎站	locale
长甸站	locale
兰棱站	locale
来舟站	locale
铁岭西站	locale
鼎湖山站	locale
白音华南站	locale
开阳站	locale
黄泥河站	locale
馗塘站	locale
新凉站	locale
荒沟西站	locale
同江站	locale
聊城东站	locale
双龙山站	locale
离堆公园站	locale
穆棱站	locale
水富站	locale
都匀站	locale
内江东站	locale
内江站	locale
宣化站	locale
赛乌苏站	locale
下马塘站	locale
沟帮子站	locale
新津站	locale
中寨站	locale
哈拉海站	locale
大营子站	locale
郑集站	locale
梁底下站	locale
藤县站	locale
十渡站	locale
石磷站	locale
罗城站	locale
彭城站	locale
长江埠站	locale
苏雄站	locale
十里村站	locale
幽州站	locale
太和站	locale
柳园站	locale
龙头寨站	locale
田梁子站	locale
高密站	locale
宜春站	locale
小南海站	locale
昆山站	locale
弋江站	locale
李家站	locale
勉西站	locale
七甸站	locale
后湖站	locale
宣家沟站	locale
女儿河站	locale
泰和站	locale
商南站	locale
芝阳站	locale
三水北站	locale
苇河站	locale
宁东站	locale
得耳布尔站	locale
革镇堡站	locale
金昌站	locale
石丫口站	locale
丹徒站	locale
达拉滨站	locale
大渡口站	locale
大口钦站	locale
黄沙河站	locale
绣峰站	locale
鹰手营子站	locale
商酒务站	locale
果松站	locale
保健站	locale
贵港站	locale
崔家营子站	locale
湾沟站	locale
东辛庄站	locale
中谊村站	locale
石门县北站	locale
五里冲站	locale
南兴安站	locale
唐山站	locale
滨海北站	locale
瑞安站	locale
千河站	locale
通道站	locale
齐齐哈尔站	locale
高碑店东站	locale
满洲里站	locale
克山站	locale
新立镇站	locale
澧县站	locale
宿松站	locale
新乐站	locale
营北站	locale
黄松甸站	locale
仙人桥站	locale
临清站	locale
大旧庄站	locale
黔江站	locale
新祺周站	locale
赣县站	locale
影壁山站	locale
池州站	locale
高邑西站	locale
汉寿站	locale
中台子站	locale
牛街庄站	locale
汉口站	locale
庙台子站	locale
西岭口站	locale
徽县站	locale
外洋站	locale
楚鲁图站	locale
歙县站	locale
下藤桥站	locale
沟口站	locale
腰栈站	locale
贺日斯台站	locale
坂田站	locale
红石站	locale
汾河站	locale
泽普站	locale
固原站	locale
蟠龙镇站	locale
旗山站	locale
尹地站	locale
墨玉站	locale
仁布站	locale
遵义北站	locale
理家坪站	locale
龙山镇站	locale
合肥南站	locale
半截河站	locale
凤凰机场站	locale
王府站	locale
即墨站	locale
春湾站	locale
三江站	locale
芦溪站	locale
谷硐站	locale
富拉尔基站	locale
三门峡西站	locale
会昌北站	locale
锡林浩特站	locale
双安屯站	locale
茂名东站	locale
汤池站	locale
松岭站	locale
向阳村站	locale
沙园站	locale
乌兰丘站	locale
三岔口站	locale
栗木站	locale
淄博站	locale
朱杨溪站	locale
辰溪站	locale
新江站	locale
元氏站	locale
哈拉站	locale
普定站	locale
阜宁站	locale
南朗站	locale
雁石站	locale
济南东站	locale
三十三号站	locale
百色站	locale
小合隆站	locale
前进镇站	locale
青龙山站	locale
小屯街站	locale
寨隆站	locale
汕头站	locale
画桥站	locale
墨池坝站	locale
磨盘山站	locale
京津所站	locale
东戴河站	locale
沭阳站	locale
邳县站	locale
楚雄站	locale
安溪站	locale
流水沟站	locale
林村站	locale
临巴溪站	locale
昆阳站	locale
前苇塘站	locale
图强站	locale
黄口站	locale
甘草店站	locale
连江站	locale
拉鲊站	locale
磨滩站	locale
伊宁东站	locale
蔡山站	locale
交界站	locale
陵城站	locale
石坝站	locale
曹王站	locale
田师府站	locale
桂平站	locale
扎赉诺尔站	locale
凯里南站	locale
聊城北站	locale
太阳升站	locale
连云港站	locale
南仇站	locale
中山北站	locale
乐坪站	locale
东至站	locale
蕉溪站	locale
固镇站	locale
水源站	locale
永康站	locale
兴凯站	locale
永平站	locale
孤山口站	locale
崔寨站	locale
临川站	locale
安口窑站	locale
三源浦站	locale
安阳站	locale
陆丰站	locale
七营站	locale
遥林站	locale
圣浪站	locale
新安庄站	locale
小池口站	locale
西里站	locale
东胜西站	locale
庆盛站	locale
大桥站	locale
子洲站	locale
古城镇站	locale
平岗站	locale
夹心子站	locale
花桥站	locale
能家站	locale
吉新河站	locale
湖口站	locale
宜山站	locale
越西站	locale
东升站	locale
乌鲁布铁站	locale
罕达盖站	locale
老岭站	locale
驻马哨站	locale
和龙站	locale
柯桥站	locale
黄石北站	locale
朱日和站	locale
天桥沟站	locale
桑园子站	locale
邓家村站	locale
甘河站	locale
开道站	locale
艾不盖站	locale
红花铺站	locale
定西北站	locale
佳木斯站	locale
福州南站	locale
德昌站	locale
羊者窝站	locale
阿湖镇站	locale
眉山东站	locale
中华门站	locale
达盖站	locale
联合乡站	locale
孙吴站	locale
黑水站	locale
马鞍山东站	locale
公主埂站	locale
金沟屯站	locale
南店站	locale
布敦化站	locale
平庄站	locale
温岭站	locale
柴岗站	locale
西宁站	locale
黄花筒站	locale
哈业胡同站	locale
李家湾站	locale
大虎山站	locale
张掖西站	locale
万隆站	locale
长沙南站	locale
衡山西站	locale
衙门庙站	locale
钦州站	locale
哈川站	locale
镇江南站	locale
胡乐站	locale
普兰店站	locale
马场站	locale
广安站	locale
茅岭站	locale
土桥子站	locale
蒙自站	locale
沁阳站	locale
白源站	locale
玉田县站	locale
洮南站	locale
磁县站	locale
新和站	locale
韩麻营站	locale
长汀站	locale
惠山站	locale
神树站	locale
司家岭站	locale
麻城站	locale
宝老山站	locale
定远站	locale
伊敏索木站	locale
坂尾站	locale
天门站	locale
光山站	locale
克一河站	locale
商城站	locale
田东北站	locale
烟筒屯站	locale
艾河站	locale
大关站	locale
杏树站	locale
南宫东站	locale
晏城北站	locale
盐城站	locale
资中站	locale
新天站	locale
霍林郭勒站	locale
史口站	locale
绿潭站	locale
月亮田站	locale
陵水站	locale
察素齐站	locale
海伦站	locale
田家沟站	locale
平湖南站	locale
普济站	locale
大乌苏站	locale
营盘水站	locale
新杖子站	locale
炎方站	locale
永安站	locale
道镇站	locale
流山站	locale
古田会址站	locale
洋河站	locale
绍兴站	locale
蒲圻站	locale
信丰站	locale
洛满站	locale
八面城站	locale
安仁站	locale
温州南站	locale
巴山站	locale
古田站	locale
常庄站	locale
沙岭子西站	locale
塔河站	locale
东兴站	locale
芦沟站	locale
桑根达来站	locale
新贤城站	locale
漳县站	locale
绩溪北站	locale
民权站	locale
太平岭站	locale
彰明站	locale
查干湖站	locale
琼海站	locale
新兴县站	locale
修武站	locale
延安北站	locale
白果站	locale
资阳北站	locale
都格站	locale
渡口站	locale
冷水江东站	locale
丰镇站	locale
西安南站	locale
文昌站	locale
茨冲站	locale
新华站	locale
金林站	locale
柳河站	locale
汉川站	locale
杨树湾站	locale
小扬气站	locale
常州北站	locale
清水站	locale
庙城站	locale
樟树东站	locale
承德东站	locale
盘锦站	locale
呼图壁站	locale
虞城县站	locale
合阳站	locale
邹城站	locale
奉化站	locale
大盘石站	locale
石泉县站	locale
湖北站	locale
新晃西站	locale
江山站	locale
呼鲁斯太站	locale
厂汗站	locale
玉屏站	locale
于家堡站	locale
四家站	locale
安多站	locale
唐家湾站	locale
汝阳站	locale
怀化南站	locale
桃村北站	locale
呼和浩特东站	locale
莫尔道嘎站	locale
福溪站	locale
关寨站	locale
凌源东站	locale
鞍山站	locale
大良站	locale
上海站	locale
弯道站	locale
阳澄湖站	locale
平田站	locale
孝感东站	locale
新兴场站	locale
豆坝站	locale
龙凤站	locale
凭祥北站	locale
花园口站	locale
墨冲站	locale
松树林站	locale
江都站	locale
黄山站	locale
和静站	locale
大荔站	locale
沛县站	locale
王堂站	locale
四道沟站	locale
衡山站	locale
孙镇站	locale
莲江口站	locale
鹿寨站	locale
洞子崖站	locale
广水站	locale
烟溪站	locale
背荫河站	locale
茶镇站	locale
孤家子站	locale
徐州站	locale
抚宁站	locale
资阳站	locale
马三家站	locale
衡阳站	locale
西乌旗站	locale
亚布力南站	locale
东戍站	locale
小市站	locale
瑞金站	locale
歪头山站	locale
滦县站	locale
阳新站	locale
恭城站	locale
三家店站	locale
保定站	locale
龙井站	locale
玉林山站	locale
万源站	locale
陇南站	locale
江永站	locale
三合庄站	locale
安富镇站	locale
柳江站	locale
衡阳东站	locale
高谷站	locale
哈力图站	locale
准沙日乌苏站	locale
自贡南站	locale
兰溪站	locale
二道沟门站	locale
昆明西站	locale
松原站	locale
丹霞山站	locale
建三江站	locale
文庄村站	locale
南阳寨站	locale
石家庄北站	locale
毛告吐站	locale
鲇鱼山站	locale
烟台南站	locale
白塔村站	locale
火炬沟站	locale
资溪站	locale
大口屯站	locale
深州站	locale
二连站	locale
文安站	locale
马棚站	locale
巴中站	locale
红花塘站	locale
常州站	locale
新墟站	locale
大城子站	locale
井冈山站	locale
南木站	locale
缙云西站	locale
漫水湾站	locale
呼中站	locale
江所田站	locale
潘家店站	locale
新余北站	locale
麻阳站	locale
阿木尔站	locale
保定东站	locale
端州站	locale
东胜站	locale
岩寺站	locale
盐津北站	locale
光泽站	locale
仪征站	locale
兖州站	locale
获嘉站	locale
南安站	locale
兰家屯站	locale
鲘门站	locale
宿州站	locale
水泉站	locale
义马站	locale
枣庄站	locale
段甲岭站	locale
绍水站	locale
登沙河站	locale
霍城站	locale
普安站	locale
陆良站	locale
捏掌站	locale
黄洋站	locale
博乐站	locale
新邱站	locale
王杨站	locale
静岭站	locale
鄂州东站	locale
阿龙山站	locale
元谋站	locale
葫芦站	locale
赤木岭站	locale
阆中站	locale
靖远站	locale
官厅站	locale
鹤壁站	locale
富宁站	locale
完工站	locale
大石头站	locale
昭通站	locale
望都站	locale
双丰站	locale
定南站	locale
庙下站	locale
皇姑屯站	locale
亚复站	locale
韩城站	locale
襄河站	locale
老坪坝站	locale
木戛站	locale
北宅站	locale
张家口南站	locale
石板滩站	locale
镇江站	locale
友谊水库站	locale
龙嘉站	locale
轮台站	locale
古坡站	locale
冕宁站	locale
平坝南站	locale
浮图峪站	locale
望亭站	locale
扎赉诺尔西站	locale
新南沟站	locale
和田站	locale
晋州站	locale
河口南站	locale
锡铁山站	locale
洞庙河站	locale
口前站	locale
南观村站	locale
老松岭站	locale
虎峰站	locale
玉山站	locale
合肥站	locale
牛耳河站	locale
炉桥站	locale
克拉玛依站	locale
文登东站	locale
东佳木斯站	locale
绅坊站	locale
将乐站	locale
余杭站	locale
林家台站	locale
随州站	locale
柳沟站	locale
乳山站	locale
建始站	locale
七家子站	locale
梁堤头站	locale
郫县西站	locale
桃村站	locale
黟县站	locale
安龙站	locale
待王站	locale
昌图西站	locale
龙塘坝站	locale
哈密东站	locale
涵江站	locale
高头站	locale
徐家坪站	locale
广宁站	locale
通渭站	locale
松林站	locale
莱西站	locale
泰康站	locale
西陌堂所站	locale
良各庄站	locale
八庙站	locale
平顶山东站	locale
桥北站	locale
北屯市站	locale
遂宁站	locale
涡阳站	locale
秦安站	locale
王岗站	locale
二道沟站	locale
冉家河站	locale
银城铺站	locale
小路溪站	locale
乌兰昭站	locale
农乐站	locale
汤原站	locale
抚州东站	locale
修武西站	locale
孟津站	locale
蛤蟆塘站	locale
木里图站	locale
大红旗站	locale